(1-3)-beta-D-glucan	
(1-6)-beta-D-glucan	
(2-amino-4-hydroxy-7,8-dihydropteridin-6-yl)methyl trihydrogen diphosphate	C1C(=NC2=C(N1)N=C(NC2=O)N)COP(=O)(O)OP(=O)(O)O
(2R,3R)-2,3-dihydroxy-3-methylpentanoate	CCC(C)(C(C(=O)[O-])O)O
(2R,3S)-3-isopropylmalate	CC(C)C(C(C(=O)[O-])O)C(=O)[O-]
(2S)-2-isopropyl-3-oxosuccinate	CC(C)C(C(=O)C(=O)O)C(=O)O
(2S,3R)-3-hydroxybutane-1,2,3-tricarboxylic acid	CC(C(CC(=O)O)C(=O)O)(C(=O)O)O
(5S,6S)-di-HETE	CCCCCC=CCC=CC=CC=CC(C(CCCC(=O)O)O)O
(N(omega)-L-arginino)succinic acid	C(CC(C(=O)O)N)CN=C(N)NC(CC(=O)O)C(=O)O
(R)-2,3-dihydroxy-3-methylbutanoate	CC(C)(C(C(=O)[O-])O)O
(R)-3-hydroxy-cis-dodec-5-enoyl-CoA	
(R)-3-hydroxy-cis-hexadec-7-enoyl-CoA	
(R)-3-hydroxy-cis-hexadec-9-enoyl-CoA	
(R)-3-hydroxy-cis-octadec-9-enoyl-CoA	
(R)-3-hydroxy-cis-tetradec-5-enoyl-CoA	
(R)-3-hydroxy-cis-tetradec-7-enoyl-CoA	
(R)-3-hydroxybutanoyl-CoA	CC(CC(=O)SCCNC(=O)CCNC(=O)C(C(C)(C)COP(=O)(O)OP(=O)(O)OCC1C(C(C(O1)N2C=NC3=C(N=CN=C32)N)O)OP(=O)(O)O)O)O
(R)-3-hydroxydecanoyl-CoA	CCCCCCCC(CC(=O)SCCNC(=O)CCNC(=O)C(C(C)(C)COP(=O)(O)OP(=O)(O)OCC1C(C(C(O1)N2C=NC3=C(N=CN=C32)N)O)OP(=O)(O)O)O)O
(R)-3-hydroxydocosanoyl-CoA	CCCCCCCCCCCCCCCCCCCC(CC(=O)SCCNC(=O)CCNC(=O)C(C(C)(C)COP(=O)(O)OP(=O)(O)OCC1C(C(C(O1)N2C=NC3=C(N=CN=C32)N)O)OP(=O)(O)O)O)O
(R)-3-hydroxyhexacosanoyl-CoA	CCCCCCCCCCCCCCCCCCCCCCCC(CC(=O)SCCNC(=O)CCNC(=O)C(C(C)(C)COP(=O)(O)OP(=O)(O)OCC1C(C(C(O1)N2C=NC3=C(N=CN=C32)N)O)OP(=O)(O)O)O)O
(R)-3-hydroxyhexanoyl-CoA	CCCC(CC(=O)SCCNC(=O)CCNC(=O)C(C(C)(C)COP(=O)([O-])OP(=O)([O-])OCC1C(C(C(O1)N2C=NC3=C(N=CN=C32)N)O)OP(=O)([O-])[O-])O)O
(R)-3-hydroxyicosanoyl-CoA	CCCCCCCCCCCCCCCCCC(CC(=O)SCCNC(=O)CCNC(=O)C(C(C)(C)COP(=O)(O)OP(=O)(O)OCC1C(C(C(O1)N2C=NC3=C(N=CN=C32)N)O)OP(=O)(O)O)O)O
(R)-3-hydroxylauroyl-CoA	CCCCCCCCCC(CC(=O)SCCNC(=O)CCNC(=O)C(C(C)(C)COP(=O)(O)OP(=O)(O)OCC1C(C(C(O1)N2C=NC3=C(N=CN=C32)N)O)OP(=O)(O)O)O)O
(R)-3-hydroxyoctadecanoyl-CoA_ActiveX VT_ERROR:	
(R)-3-hydroxyoctanoyl-CoA	CCCCCC(CC(=O)SCCNC(=O)CCNC(=O)C(C(C)(C)COP(=O)(O)OP(=O)(O)OCC1C(C(C(O1)N2C=NC3=C(N=CN=C32)N)O)OP(=O)(O)O)O)O
(R)-3-hydroxypalmitoyl-CoA	CCCCCCCCCCCCCC(CC(=O)SCCNC(=O)CCNC(=O)C(C(C)(C)COP(=O)(O)OP(=O)(O)OCC1C(C(C(O1)N2C=NC3=C(N=CN=C32)N)O)OP(=O)(O)O)O)O
(R)-3-hydroxytetracosanoyl-CoA	CCCCCCCCCCCCCCCCCCCCCC(CC(=O)SCCNC(=O)CCNC(=O)C(C(C)(C)COP(=O)(O)OP(=O)(O)OCC1C(C(C(O1)N2C=NC3=C(N=CN=C32)N)O)OP(=O)(O)O)O)O
(R)-3-hydroxytetradecanoyl-CoA_ActiveX VT_ERROR:	
(R)-4'-phosphopantothenic acid	CC(C)(COP(=O)(O)O)C(C(=O)NCCC(=O)O)O
(R)-5-diphosphomevalonic acid	CC(CCOP(=O)(O)OP(=O)(O)O)(CC(=O)O)O
(R)-5-phosphomevalonic acid	CC(CCOP(=O)(O)O)(CC(=O)O)O
(R)-S-lactoylglutathione	CC(C(=O)SCC(C(=O)NCC(=O)O)NC(=O)CCC(C(=O)O)N)O
(R)-acetoin	CC(C(=O)C)O
(R)-carnitine	C[N+](C)(C)CC(CC(=O)[O-])O
(R)-lactate	CC(C(=O)O)O
(R)-mevalonate	CC(CCO)(CC(=O)[O-])O
(R)-pantoate	CC(C)(CO)C(C(=O)[O-])O
(R)-pantothenate	CC(C)(CO)C(C(=O)NCCC(=O)O)O
(R,R)-2,3-butanediol_ActiveX VT_ERROR:	
(S)-2,3-epoxysqualene	CC(=CCCC(=CCCC(=CCCC=C(C)CCC=C(C)CCC1C(O1)(C)C)C)C)C
(S)-2-acetyl-2-hydroxybutanoate	CCC(C(=O)C)(C(=O)[O-])O
(S)-2-methylbutanoyl-CoA	CCC(C)C(=O)SCCNC(=O)CCNC(=O)C(C(C)(C)COP(=O)(O)OP(=O)(O)OCC1C(C(C(O1)N2C=NC3=C(N=CN=C32)N)O)OP(=O)(O)O)O
(S)-3-hydroxybutanoyl-CoA	CC(CC(=O)SCCNC(=O)CCNC(=O)C(C(C)(C)COP(=O)(O)OP(=O)(O)OCC1C(C(C(O1)N2C=NC3=C(N=CN=C32)N)O)OP(=O)(O)O)O)O
(S)-3-hydroxyhexacosanoyl-CoA	CCCCCCCCCCCCCCCCCCCCCCCC(CC(=O)SCCNC(=O)CCNC(=O)C(C(C)(C)COP(=O)(O)OP(=O)(O)OCC1C(C(C(O1)N2C=NC3=C(N=CN=C32)N)O)OP(=O)(O)O)O)O
(S)-3-hydroxypalmitoyl-CoA	CCCCCCCCCCCCCC(CC(=O)SCCNC(=O)CCNC(=O)C(C(C)(C)COP(=O)(O)OP(=O)(O)OCC1C(C(C(O1)N2C=NC3=C(N=CN=C32)N)O)OP(=O)(O)O)O)O
(S)-3-hydroxytetradecanoyl-CoA	CCCCCCCCCCCC(CC(=O)SCCNC(=O)CCNC(=O)C(C(C)(C)COP(=O)(O)OP(=O)(O)OCC1C(C(C(O1)N2C=NC3=C(N=CN=C32)N)O)OP(=O)(O)O)O)O
(S)-3-methyl-2-oxopentanoate	CCC(C)C(=O)C(=O)O
(S)-dihydroorotate	C1C(NC(=O)NC1=O)C(=O)O
(S)-lactaldehyde	CC(C=O)O
(S)-lactate	CC(C(=O)O)O
(S)-malate	C(C(C(=O)O)O)C(=O)O
1,2-diacylglycerol 3-diphosphate	
1,3-bisphospho-D-glycerate	C(C(C(=O)OP(=O)(O)O)O)OP(=O)(O)O
1-(2-carboxyphenylamino)-1-deoxy-D-ribulose 5-phosphate	C1=CC=C(C(=C1)C(=O)O)NCC(=O)C(C(COP(=O)(O)O)O)O
1-(5-phospho-D-ribosyl)-5-[(5-phospho-D-ribosylamino)methylideneamino]imidazole-4-carboxamide	
1-(5-phosphoribosyl)-5'-AMP	
1-(sn-glycero-3-phospho)-1D-myo-inositol	C(C(COP(=O)(O)OC1C(C(C(C(C1O)O)O)O)O)O)O
1-C-(indol-3-yl)glycerol 3-phosphate	C1=CC=C2C(=C1)C(=CN2)C(C(COP(=O)(O)O)O)O
1-acyl-sn-glycerol 3-phosphate_ActiveX VT_ERROR:	
1-acylglycerophosphocholine	
1-acylglycerophosphoethanolamine	
1-acylglycerophosphoinositol	
1-acylglycerophosphoserine	
1-methylnicotinamide	C[N+]1=CC=CC(=C1)C(=O)N
1-monoglyceride	
1-phosphatidyl-1D-myo-inositol 3,5-bisphosphate_ActiveX VT_ERROR:	
1-phosphatidyl-1D-myo-inositol 3-phosphate_ActiveX VT_ERROR:	
1-phosphatidyl-1D-myo-inositol 4,5-bisphosphate_ActiveX VT_ERROR:	
1-phosphatidyl-1D-myo-inositol 4-phosphate_ActiveX VT_ERROR:	
1-phosphatidyl-1D-myo-inositol_ActiveX VT_ERROR:	
1-pyrroline-3-hydroxy-5-carboxylic acid	C1C(C=NC1C(=O)O)O
1-pyrroline-5-carboxylate	C1CC(N=C1)C(=O)O
10-formyl-THF	C1C(NC2=C(N1)N=C(NC2=O)N)CN(C=O)C3=CC=C(C=C3)C(=O)NC(CCC(=O)O)C(=O)O
14-demethyllanosterol	CC(CCC=C(C)C)C1CCC2C1(CCC3=C2CCC4C3(CCC(C4(C)C)O)C)C
1D-myo-inositol 1,3,4,5-tetrakisphosphate_ActiveX VT_ERROR:	
1D-myo-inositol 1,4,5,6-tetrakisphosphate_ActiveX VT_ERROR:	
1D-myo-inositol 1,4,5-trisphosphate	C1(C(C(C(C(C1OP(=O)(O)O)O)OP(=O)(O)O)OP(=O)(O)O)O)O
1D-myo-inositol 1-phosphate	C1(C(C(C(C(C1O)O)OP(=O)(O)O)O)O)O
1D-myo-inositol 3-phosphate	C1(C(C(C(C(C1O)O)OP(=O)(O)O)O)O)O
2'-deoxyadenosine	C1C(C(OC1N2C=NC3=C(N=CN=C32)N)CO)O
2'-deoxyguanosine	C1C(C(OC1N2C=NC3=C2N=C(NC3=O)N)CO)O
2'-deoxyinosine	C1C(C(OC1N2C=NC3=C2N=CNC3=O)CO)O
2'-deoxyinosine-5-phosphate	
2'-deoxyuridine	C1C(C(OC1N2C=CC(=O)NC2=O)CO)O
2,3-bisphospho-D-glyceric acid	C(C(C(=O)O)OP(=O)(O)O)OP(=O)(O)O
2,5-diamino-4-hydroxy-6-(5-phosphoribosylamino)pyrimidine	C(C1C(C(C(O1)NC2=C(C(=O)NC(=N2)N)N)O)O)OP(=O)(O)O
2,5-diamino-6-(5-phosphono)ribitylamino-4(3H)-pyrimidinone	C(C(C(C(COP(=O)(O)O)O)O)O)NC1=C(C(=O)NC(=N1)N)N
2-(3-amino-3-carboxypropyl)-L-histidine	C1=C(NC(=N1)CCC(C(=O)O)N)CC(C(=O)O)N
2-[3-carboxy-3-(methylammonio)propyl]-L-histidine	C[NH2+]C(CCC1=NC=C(N1)CC(C(=O)O)N)C(=O)O
2-acetamido-5-oxopentanoate	CC(=O)NC(CCC=O)C(=O)[O-]
2-acetyllactic acid	CC(=O)C(C)(C(=O)O)O
2-amino-3-carboxymuconate-6-semialdehyde	C(=CC(=C(C(=O)O)N)C(=O)O)C=O
2-amino-6-(hydroxymethyl)-7,8-dihydropteridin-4-ol	C1C(=NC2=C(N1)N=C(NC2=O)N)CO
2-dehydropantoate	CC(C)(CO)C(=O)C(=O)O
2-deoxy-D-ribofuranose 1-phosphate	C1C(C(OC1OP(=O)(O)O)CO)O
2-deoxy-D-ribose 5-phosphate	
2-deoxy-D-ribose_ActiveX VT_ERROR:	
2-hexaprenyl-5-hydroxy-6-methoxy-3-methyl-1,4-benzoquinone	CC1=C(C(=O)C(=C(C1=O)O)OC)CC=C(C)CCC=C(C)CCC=C(C)CCC=C(C)CCC=C(C)CCC=C(C)C
2-hexaprenyl-6-methoxy-1,4-benzoquinone	CC(=CCCC(=CCCC(=CCCC(=CCCC(=CCCC(=CCC1=CC(=O)C=C(C1=O)OC)C)C)C)C)C)C
2-hexaprenyl-6-methoxy-3-methyl-1,4-benzoquinone	CC1=C(C(=O)C(=CC1=O)OC)CC=C(C)CCC=C(C)CCC=C(C)CCC=C(C)CCC=C(C)CCC=C(C)C
2-hexaprenyl-6-methoxyphenol	CC(=CCCC(=CCCC(=CCCC(=CCCC(=CCCC(=CCC1=C(C(=CC=C1)OC)O)C)C)C)C)C)C
2-hydroxy-3-oxobutyl phosphate	CC(=O)C(COP(=O)(O)O)O
2-hydroxyhexadecanal	CCCCCCCCCCCCCCC(C=O)O
2-isopropylmalate	CC(C)C(CC(=O)O)(C(=O)O)O
2-isopropylmaleic acid	CC(C)C(=CC(=O)O)C(=O)O
2-methylcitrate	CC(C(=O)O)C(CC(=O)O)(C(=O)O)O
2-methylpropanoyl-CoA	CC(C)C(=O)SCCNC(=O)CCNC(=O)C(C(C)(C)COP(=O)(O)OP(=O)(O)OCC1C(C(C(O1)N2C=NC3=C(N=CN=C32)N)O)OP(=O)(O)O)O
2-oxoadipic acid	C(CC(=O)C(=O)O)CC(=O)O
2-oxobutanoate	CCC(=O)C(=O)[O-]
2-oxoglutarate	C(CC(=O)O)C(=O)C(=O)O
2-phospho-D-glyceric acid	C(C(C(=O)O)OP(=O)(O)O)O
3',5'-cyclic AMP	C1C2C(C(C(O2)N3C=NC4=C(N=CN=C43)N)O)OP(=O)(O1)O
3',5'-cyclic CMP	C1C2C(C(C(O2)N3C=CC(=NC3=O)N)O)OP(=O)(O1)O
3',5'-cyclic GMP	C1C2C(C(C(O2)N3C=NC4=C3N=C(NC4=O)N)O)OP(=O)(O1)O
3',5'-cyclic IMP	C1C2C(C(C(O2)N3C=NC4=C3N=CNC4=O)O)OP(=O)(O1)O
3',5'-cyclic dAMP	C1C2C(COP(=O)(O2)O)OC1N3C=NC4=C(N=CN=C43)N
3'-dephospho-CoA	CC(C)(COP(=O)(O)OP(=O)(O)OCC1C(C(C(O1)N2C=NC3=C(N=CN=C32)N)O)O)C(C(=O)NCCC(=O)NCCS)O
3'-phospho-5'-adenylyl sulfate	C1=NC(=C2C(=N1)N(C=N2)C3C(C(C(O3)COP(=O)(O)OS(=O)(=O)O)OP(=O)(O)O)O)N
3-(3-sn-phosphatidyl)-sn-glycerol 1-phosphate	
3-(4-hydroxyphenyl)pyruvate	C1=CC(=CC=C1CC(=O)C(=O)[O-])O
3-(imidazol-4-yl)-2-oxopropyl dihydrogen phosphate	C1=C(NC=N1)CC(=O)COP(=O)(O)O
3-aminopropanal	C(CN)C=O
3-dehydro-4-methylzymosterol	CC1C2CCC3=C(C2(CCC1=O)C)CCC4(C3CCC4C(C)CCC=C(C)C)C
3-dehydroquinate	C1C(C(C(=O)CC1(C(=O)[O-])O)O)O
3-dehydroshikimate	C1C(C(C(=O)C=C1C(=O)O)O)O
3-hexaprenyl-4,5-dihydroxybenzoic acid	CC(=CCCC(=CCCC(=CCCC(=CCCC(=CCCC(=CCC1=C(C(=CC(=C1)C(=O)O)O)O)C)C)C)C)C)C
3-hexaprenyl-4-hydroxy-5-methoxybenzoic acid	CC(=CCCC(=CCCC(=CCCC(=CCCC(=CCCC(=CCC1=C(C(=CC(=C1)C(=O)O)OC)O)C)C)C)C)C)C
3-hexaprenyl-4-hydroxybenzoic acid	CC(=CCCC(=CCCC(=CCCC(=CCCC(=CCCC(=CCC1=C(C=CC(=C1)C(=O)O)O)C)C)C)C)C)C
3-hydroxy-3-methylglutaryl-CoA	CC(C)(COP(=O)(O)OP(=O)(O)OCC1C(C(C(O1)N2C=NC3=C(N=CN=C32)N)O)OP(=O)(O)O)C(C(=O)NCCC(=O)NCCSC(=O)CC(C)(CC(=O)O)O)O
3-hydroxy-L-kynurenine	C1=CC(=C(C(=C1)O)N)C(=O)CC(C(=O)O)N
3-hydroxyanthranilate	C1=CC(=C(C(=C1)O)N)C(=O)O
3-hydroxybutanoyl-ACP	
3-hydroxydocosanoyl-CoA	CCCCCCCCCCCCCCCCCCCC(CC(=O)SCCNC(=O)CCNC(=O)C(C(C)(C)COP(=O)(O)OP(=O)(O)OCC1C(C(C(O1)N2C=NC3=C(N=CN=C32)N)O)OP(=O)(O)O)O)O
3-hydroxyhexanoyl-ACP	
3-hydroxyicosanoyl-CoA	CCCCCCCCCCCCCCCCCC(CC(=O)SCCNC(=O)CCNC(=O)C(C(C)(C)COP(=O)(O)OP(=O)(O)OCC1C(C(C(O1)N2C=NC3=C(N=CN=C32)N)O)OP(=O)(O)O)O)O
3-hydroxyoctadecanoyl-CoA	CCCCCCCCCCCCCCCC(CC(=O)SCCNC(=O)CCNC(=O)C(C(C)(C)COP(=O)(O)OP(=O)(O)OCC1C(C(C(O1)N2C=NC3=C(N=CN=C32)N)O)OP(=O)(O)O)O)O
3-hydroxyoctanoyl-ACP	
3-hydroxytetracosanoyl-CoA	CCCCCCCCCCCCCCCCCCCCCC(CC(=O)SCCNC(=O)CCNC(=O)C(C(C)(C)COP(=O)(O)OP(=O)(O)OCC1C(C(C(O1)N2C=NC3=C(N=CN=C32)N)O)OP(=O)(O)O)O)O
3-ketosphinganine	CCCCCCCCCCCCCCCC(=O)C(CO)N
3-methyl-2-oxobutanoate	CC(C)C(=O)C(=O)O
3-methylbutanoyl-CoA	CC(C)CC(=O)SCCNC(=O)CCNC(=O)C(C(C)(C)COP(=O)(O)OP(=O)(O)OCC1C(C(C(O1)N2C=NC3=C(N=CN=C32)N)O)OP(=O)(O)O)O
3-methylcrotonyl-CoA	CC(=CC(=O)SCCNC(=O)CCNC(=O)C(C(C)(C)COP(=O)(O)OP(=O)(O)OCC1C(C(C(O1)N2C=NC3=C(N=CN=C32)N)O)OP(=O)(O)O)O)C
3-methylglutaconyl-CoA	CC(=CC(=O)SCCNC(=O)CCNC(=O)C(C(C)(C)COP(=O)(O)OP(=O)(O)OCC1C(C(C(O1)N2C=NC3=C(N=CN=C32)N)O)OP(=O)(O)O)O)CC(=O)O
3-oxo-cis-dodec-5-enoyl-CoA	
3-oxo-cis-hexadec-7-enoyl-CoA	
3-oxo-cis-hexadec-9-enoyl-CoA	
3-oxo-cis-octadec-9-enoyl-CoA	
3-oxo-cis-tetradec-5-enoyl-CoA	
3-oxo-cis-tetradec-7-enoyl-CoA	
3-oxo-hexanoyl-ACP	
3-oxo-octanoyl-ACP	
3-oxodecanoyl-CoA	CCCCCCCC(=O)CC(=O)SCCNC(=O)CCNC(=O)C(C(C)(C)COP(=O)(O)OP(=O)(O)OCC1C(C(C(O1)N2C=NC3=C(N=CN=C32)N)O)OP(=O)(O)O)O
3-oxodocosanoyl-CoA	CCCCCCCCCCCCCCCCCCCC(=O)CC(=O)SCCNC(=O)CCNC(=O)C(C(C)(C)COP(=O)(O)OP(=O)(O)OCC1C(C(C(O1)N2C=NC3=C(N=CN=C32)N)O)OP(=O)(O)O)O
3-oxohexacosanoyl-CoA	CCCCCCCCCCCCCCCCCCCCCCCC(=O)CC(=O)SCCNC(=O)CCNC(=O)C(C(C)(C)COP(=O)(O)OP(=O)(O)OCC1C(C(C(O1)N2C=NC3=C(N=CN=C32)N)O)OP(=O)(O)O)O
3-oxohexanoyl-CoA	CCCC(=O)CC(=O)SCCNC(=O)CCNC(=O)C(C(C)(C)COP(=O)(O)OP(=O)(O)OCC1C(C(C(O1)N2C=NC3=C(N=CN=C32)N)O)OP(=O)(O)O)O
3-oxoicosanoyl-CoA	CCCCCCCCCCCCCCCCCC(=O)CC(=O)SCCNC(=O)CCNC(=O)C(C(C)(C)COP(=O)(O)OP(=O)(O)OCC1C(C(C(O1)N2C=NC3=C(N=CN=C32)N)O)OP(=O)(O)O)O
3-oxolauroyl-CoA	CCCCCCCCCC(=O)CC(=O)SCCNC(=O)CCNC(=O)C(C(C)(C)COP(=O)(O)OP(=O)(O)OCC1C(C(C(O1)N2C=NC3=C(N=CN=C32)N)O)OP(=O)(O)O)O
3-oxooctadecanoyl-CoA	CCCCCCCCCCCCCCCC(=O)CC(=O)SCCNC(=O)CCNC(=O)C(C(C)(C)COP(=O)(O)OP(=O)(O)OCC1C(C(C(O1)N2C=NC3=C(N=CN=C32)N)O)OP(=O)(O)O)O
3-oxooctanoyl-CoA	CCCCCC(=O)CC(=O)SCCNC(=O)CCNC(=O)C(C(C)(C)COP(=O)(O)OP(=O)(O)OCC1C(C(C(O1)N2C=NC3=C(N=CN=C32)N)O)OP(=O)(O)O)O
3-oxopalmitoyl-CoA	CCCCCCCCCCCCCC(=O)CC(=O)SCCNC(=O)CCNC(=O)C(C(C)(C)COP(=O)(O)OP(=O)(O)OCC1C(C(C(O1)N2C=NC3=C(N=CN=C32)N)O)OP(=O)(O)O)O
3-oxotetracosanoyl-CoA	CCCCCCCCCCCCCCCCCCCCCC(=O)CC(=O)SCCNC(=O)CCNC(=O)C(C(C)(C)COP(=O)(O)OP(=O)(O)OCC1C(C(C(O1)N2C=NC3=C(N=CN=C32)N)O)OP(=O)(O)O)O
3-oxotetradecanoyl-CoA	CCCCCCCCCCCC(=O)CC(=O)SCCNC(=O)CCNC(=O)C(C(C)(C)COP(=O)(O)OP(=O)(O)OCC1C(C(C(O1)N2C=NC3=C(N=CN=C32)N)O)OP(=O)(O)O)O
3-phospho-hydroxypyruvate	C(C(=O)C(=O)[O-])OP(=O)([O-])[O-]
3-phospho-serine	C(C(C(=O)O)N)OP(=O)(O)O
3-phosphoglycerate	C(C(C(=O)O)O)OP(=O)(O)O
3-phosphoshikimic acid	C1C(C(C(C=C1C(=O)O)OP(=O)(O)O)O)O
4,4-dimethyl-5alpha-cholesta-8,14,24-trien-3beta-ol	CC(CCC=C(C)C)C1CC=C2C1(CCC3=C2CCC4C3(CCC(C4(C)C)O)C)C
4,5-bis(diphospho)-1D-myo-inositol tetrakisphosphate	C1(C(C(C(C(C1OP(=O)(O)O)OP(=O)(O)OP(=O)(O)O)OP(=O)(O)OP(=O)(O)O)OP(=O)(O)O)OP(=O)(O)O)OP(=O)(O)O
4-(phosphonooxy)-L-threonine	C(C(C(C(=O)O)N)O)OP(=O)(O)O
4-amino-2-methyl-5-diphosphomethylpyrimidine	CC1=NC=C(C(=N1)N)COP(=O)(O)OP(=O)(O)O
4-amino-2-methyl-5-phosphomethylpyrimidine	CC1=NC=C(C(=N1)N)COP(=O)(O)O
4-amino-4-deoxychorismate	C=C(C(=O)O)OC1C=C(C=CC1N)C(=O)O
4-amino-5-hydroxymethyl-2-methylpyrimidine	CC1=NC=C(C(=N1)N)CO
4-aminobenzoate	C1=CC(=CC=C1C(=O)[O-])N
4-aminobutanal	C(CC=O)CN
4-diphospho-1D-myo-inositol pentakisphosphate	C1(C(C(C(C(C1OP(=O)(O)O)OP(=O)(O)O)OP(=O)(O)OP(=O)(O)O)OP(=O)(O)O)OP(=O)(O)O)OP(=O)(O)O
4-fumaryl-acetoacetate	C(C(=O)CC(=O)O)C(=O)C=CC(=O)O
4-guanidinobutanamide	C(CC(=O)N)CN=C(N)N
4-guanidinobutanoic acid	C(CC(=O)O)CN=C(N)N
4-hydroxy-2-oxoglutarate	C(C(C(=O)O)O)C(=O)C(=O)O
4-hydroxy-L-threonine	C(C(C(C(=O)O)N)O)O
4-hydroxybenzoate	C1=CC(=CC=C1C(=O)O)[O-]
4-hydroxybenzoyl-CoA	CC(C)(COP(=O)(O)OP(=O)(O)OCC1C(C(C(O1)N2C=NC3=C(N=CN=C32)N)O)OP(=O)(O)O)C(C(=O)NCCC(=O)NCCSC(=O)C4=CC=C(C=C4)O)O
4-maleyl-acetoacetate	C(C(=O)CC(=O)[O-])C(=O)C=CC(=O)[O-]
4-methyl-2-oxopentanoate	CC(C)CC(=O)C(=O)O
4-methyl-5-(2-phosphonooxyethyl)thiazole	CC1=C(SC=N1)CCOP(=O)(O)O
4-methylthio-2-oxobutanoate	CSCCC(=O)C(=O)O
4-phospho-L-aspartate	C(C(C(=O)O)N)C(=O)OP(=O)(O)O
4alpha-methylzymosterol	CC1C2CCC3=C(C2(CCC1O)C)CCC4(C3CCC4C(C)CCC=C(C)C)C
4beta-methylzymosterol-4alpha-carboxylic acid	CC(CCC=C(C)C)C1CCC2C1(CCC3=C2CCC4C3(CCC(C4(C)C(=O)O)O)C)C
5'-S-methyl-5'-thioadenosine	CSCC1C(C(C(O1)N2C=NC3=C(N=CN=C32)N)O)O
5'-adenylyl sulfate	C1=NC(=C2C(=N1)N(C=N2)C3C(C(C(O3)COP(=O)(O)OS(=O)(=O)O)O)O)N
5'-phosphoribosyl-4-(N-succinocarboxamide)-5-aminoimidazole	C1=NC(=C(N1C2C(C(C(O2)COP(=O)(O)O)O)O)N)C(=O)NC(CC(=O)O)C(=O)O
5'-phosphoribosyl-5-aminoimidazole	C1=C(N(C=N1)C2C(C(C(O2)COP(=O)(O)O)O)O)N
5'-phosphoribosyl-N-formylglycineamide	C(C1C(C(C(O1)NC(=O)CNC=O)O)O)OP(=O)(O)O
5'-phosphoribosyl-N-formylglycineamidine	
5,10-methenyl-THF	C1C2CN(C=[N+]2C3=C(N1)N=C(NC3=O)N)C4=CC=C(C=C4)C(=O)NC(CCC(=O)O)C(=O)[O-]
5,10-methylenetetrahydrofolate	C1C2CN(CN2C3=C(N1)N=C(NC3=O)N)C4=CC=C(C=C4)C(=O)NC(CCC(=O)O)C(=O)O
5,6,7,8-tetrahydrofolyl-L-glutamic acid	C1C(NC2=C(N1)N=C(NC2=O)N)CNC3=CC=C(C=C3)C(=O)NC(CCC(=O)NC(CCC(=O)O)C(=O)O)C(=O)O
5,6-bis(diphospho)-1D-myo-inositol tetrakisphosphate	C1(C(C(C(C(C1OP(=O)(O)O)OP(=O)(O)OP(=O)(O)O)OP(=O)(O)OP(=O)(O)O)OP(=O)(O)O)OP(=O)(O)O)OP(=O)(O)O
5-(2-hydroxyethyl)-4-methylthiazole	CC1=C(SC=N1)CCO
5-(methylsulfanyl)-2,3-dioxopentyl phosphate	CSCCC(=O)C(=O)COP(=O)(O)O
5-O-(1-carboxyvinyl)-3-phosphoshikimic acid	C=C(C(=O)O)OC1CC(=CC(C1O)OP(=O)(O)O)C(=O)O
5-[(5-phospho-1-deoxy-D-ribulos-1-ylamino)methylideneamino]-1-(5-phospho-D-ribosyl)imidazole-4-carboxamide	
5-amino-6-(5-phosphoribitylamino)uracil	C(C(C(C(COP(=O)(O)O)O)O)O)NC1=C(C(=O)NC(=O)N1)N
5-amino-6-(D-ribitylamino)uracil	C(C(C(C(CO)O)O)O)NC1=C(C(=O)NC(=O)N1)N
5-aminolevulinate	C(CC(=O)O)C(=O)CN
5-diphospho-1D-myo-inositol pentakisphosphate	C1(C(C(C(C(C1OP(=O)(O)O)OP(=O)(O)O)OP(=O)(O)OP(=O)(O)O)OP(=O)(O)O)OP(=O)(O)O)OP(=O)(O)O
5-formyltetrahydrofolic acid	C1C(N(C2=C(N1)N=C(NC2=O)N)C=O)CNC3=CC=C(C=C3)C(=O)NC(CCC(=O)O)C(=O)O
5-hydroxyisourate	C12=NC(=O)NC1(C(=O)NC(=O)N2)O
5-methyltetrahydrofolate	CN1C(CNC2=C1C(=O)NC(=N2)N)CNC3=CC=C(C=C3)C(=O)NC(CCC(=O)O)C(=O)O
5-methyltetrahydropteroyltri-L-glutamic acid	CN1C(CNC2=C1C(=O)NC(=N2)N)CNC3=CC=C(C=C3)C(=O)NC(CCC(=O)NC(CCC(=O)NC(CCC(=O)O)C(=O)O)C(=O)O)C(=O)O
5-oxoproline	C1CC(=O)NC1C(=O)O
5-phospho-ribosyl-glycineamide	
5-phosphoribosyl-ATP	C1=NC2=C(N1C3C(C(C(O3)COP(=O)([O-])OP(=O)([O-])OP(=O)([O-])[O-])O)O)N=CN(C2=N)C4C(C(C(O4)COP(=O)([O-])[O-])O)O
5-phosphoribosylamine	C(C1C(C(C(O1)N)O)O)OP(=O)(O)O
6,7-dimethyl-8-(1-D-ribityl)lumazine	CC1=C(N(C2=NC(=O)NC(=O)C2=N1)CC(C(C(CO)O)O)O)C
6-(N-acetyl-alpha-D-glucosaminyl)-1-phosphatidyl-1D-myo-inositol	CC(=O)NC1C(C(C(OC1OC2C(C(C(C(C2OP(=O)(O)OCC(COC(=O)C)OC(=O)C)O)O)O)O)CO)O)O
6-(alpha-D-glucosaminyl)-1-phosphatidyl-1D-myo-inositol	C(C1C(C(C(C(O1)OC2C(C(C(C(C2OP(=O)(O)OCC(COC=O)OC=O)O)O)O)O)N)O)O)O
6-(alpha-D-glucosaminyl)-O-acyl-1-phosphatidyl-1D-myo-inositol	
6-O-[alpha-D-mannosyl-(1-4)-alpha-D-glucosaminyl]-O-acyl-1-phosphatidyl-1D-myo-inositol	
6-O-phosphono-D-glucono-1,5-lactone	C(C1C(C(C(C(=O)O1)O)O)O)OP(=O)(O)O
6-O-{2-O-[(2-aminoethyl)phosphoryl]-alpha-D-mannosyl-(1-4)-alpha-D-glucosaminyl}-O-acyl-1-phosphatidyl-1D-myo-inositol	
6-O-{alpha-D-mannosyl-(1-2)-alpha-D-mannosyl-(1-6)-2-O-[(2-aminoethyl)phosphoryl]-alpha-D-mannosyl-(1-4)-alpha-D-glucosaminyl}-O-acyl-1-phosphatidyl-1D-myo-inositol	
6-O-{alpha-D-mannosyl-(1-6)-2-O-[(2-aminoethyl)phosphoryl]-alpha-D-mannosyl-(1-4)-alpha-D-glucosaminyl}-O-acyl-1-phosphatidyl-1D-myo-inositol	
6-[6-(2-aminoethylphosphoryl)-alpha-mannosyl-(1-6)-2-(2-aminoethylphosphoryl)-alpha-mannosyl-(1-6)-alpha-2-(2-aminoethylphosphoryl)mannosyl-(1-4)-alpha-glucosaminyl]-O-acyl-1-phosphatidyl-1D-myo-inositol	
6-diphospho-1D-myo-inositol pentakisphosphate	C1(C(C(C(C(C1OP(=O)(O)O)OP(=O)(O)O)OP(=O)(O)OP(=O)(O)O)OP(=O)(O)O)OP(=O)(O)O)OP(=O)(O)O
6-phospho-D-gluconate	C(C(C(C(C(C(=O)O)O)O)O)O)OP(=O)(O)O
7,8-diaminononanoate	CC(C(CCCCCC(=O)O)N)N
7,8-dihydroneopterin	C1C(=NC2=C(N1)N=C(NC2=O)N)C(C(CO)O)O
7,8-dihydroneopterin 3'-phosphate	C1C(=NC2=C(N1)N=C(NC2=O)N)C(C(COP(=O)(O)O)O)O
7,8-dihydroneopterin 3'-triphosphate	C1C(=NC2=C(N1)N=C(NC2=O)N)C(C(COP(=O)(O)OP(=O)(O)OP(=O)(O)O)O)O
7,8-dihydropteroate_ActiveX VT_ERROR:	
7-phospho-2-dehydro-3-deoxy-D-arabino-heptonic acid	C(C(C(C(COP(=O)(O)O)O)O)O)C(=O)C(=O)O
8-amino-7-oxononanoate	CC(C(=O)CCCCCC(=O)[O-])N
9H-xanthine	C1=NC2=C(N1)C(=O)NC(=O)N2
ACP1	
ADP	C1=NC(=C2C(=N1)N(C=N2)C3C(C(C(O3)COP(=O)(O)OP(=O)(O)O)O)O)N
ADP-ribose	C1=NC(=C2C(=N1)N(C=N2)C3C(C(C(O3)COP(=O)(O)OP(=O)(O)OCC4C(C(C(O4)O)O)O)O)O)N
AICAR	C1=NC(=C(N1C2C(C(C(O2)CO)O)O)N)C(=O)N
AMP	C1=NC(=C2C(=N1)N(C=N2)C3C(C(C(O3)COP(=O)(O)O)O)O)N
ATP	C1=NC(=C2C(=N1)N(C=N2)C3C(C(C(O3)COP(=O)(O)OP(=O)(O)OP(=O)(O)O)O)O)N
Ala-tRNA(Ala)_C13H22NO11PR2(C5H8O6PR)n	
Arg-tRNA(Arg)_C21H33N9O11PR(C5H8O6PR)n	
Asn-tRNA(Asn)_C14H23N2O12PR2(C5H8O6PR)n	
Asp-tRNA(Asp)_C14H22NO13PR2(C5H8O6PR)n	
CDP	C1=CN(C(=O)N=C1N)C2C(C(C(O2)COP(=O)(O)OP(=O)(O)O)O)O
CDP-choline	C[N+](C)(C)CCOP(=O)([O-])OP(=O)(O)OCC1C(C(C(O1)N2C=CC(=NC2=O)N)O)O
CDP-diacylglycerol	
CDP-ethanolamine	C1=CN(C(=O)N=C1N)C2C(C(C(O2)COP(=O)(O)OP(=O)(O)OCCN)O)O
CMP	C1=CN(C(=O)N=C1N)C2C(C(C(O2)COP(=O)(O)O)O)O
CTP	C1=CN(C(=O)N=C1N)C2C(C(C(O2)COP(=O)(O)OP(=O)(O)OP(=O)(O)O)O)O
Cys-tRNA(Cys)_C18H26N6O11PSR(C5H8O6PR)n	
D-arabinitol	C(C(C(C(CO)O)O)O)O
D-arabinono-1,4-lactone	C(C1C(C(C(=O)O1)O)O)O
D-arabinose	
D-erythro-1-(imidazol-4-yl)glycerol 3-phosphate	C1=C(NC=N1)C(C(COP(=O)(O)O)O)O
D-erythrose 4-phosphate	C(C(C(C=O)O)O)OP(=O)(O)O
D-fructose	C1C(C(C(C(O1)(CO)O)O)O)O
D-fructose 1,6-bisphosphate	
D-fructose 1-phosphate	C(C(C(C(C(=O)COP(=O)(O)O)O)O)O)O
D-fructose 6-phosphate	C(C(C(C(C(=O)CO)O)O)O)OP(=O)(O)O
D-galactose	C(C1C(C(C(C(O1)O)O)O)O)O
D-galacturonate_ActiveX VT_ERROR:	
D-glucitol	C(C(C(C(C(CO)O)O)O)O)O
D-gluconate_ActiveX VT_ERROR:	
D-glucosamine	C(C1C(C(C(C(O1)O)N)O)O)O
D-glucose	C(C1C(C(C(C(O1)O)O)O)O)O
D-glucose 1-phosphate	C(C1C(C(C(C(O1)OP(=O)(O)O)O)O)O)O
D-glucose 6-phosphate	C(C(C(C(C(C=O)O)O)O)O)OP(=O)(O)O
D-glyceraldehyde	C(C(C=O)O)O
D-mannitol	C(C(C(C(C(CO)O)O)O)O)O
D-mannose	C(C1C(C(C(C(O1)O)O)O)O)O
D-mannose 1-phosphate	C(C1C(C(C(C(O1)OP(=O)(O)O)O)O)O)O
D-mannose 6-phosphate	C(C1C(C(C(C(O1)O)O)O)O)OP(=O)(O)O
D-ribose	C1C(C(C(C(O1)O)O)O)O
D-ribulose 5-phosphate	C(C(C(C(=O)CO)O)O)OP(=O)(O)O
D-serine	C(C(C(=O)O)N)O
D-xylose	C1C(C(C(C(O1)O)O)O)O
D-xylulose	C(C(C(C(=O)CO)O)O)O
D-xylulose 5-phosphate	C(C(C(C(=O)CO)O)O)OP(=O)(O)O
DNA	
Delta(6)-trans,Delta(8)-cis-leukotriene B4	CCCCCC=CCC(C=CC=CC=CC(CCCC(=O)O)O)O
FAD	CC1=CC2=C(C=C1C)N(C3=NC(=O)NC(=O)C3=N2)CC(C(C(COP(=O)(O)OP(=O)(O)OCC4C(C(C(O4)N5C=NC6=C(N=CN=C65)N)O)O)O)O)O
FADH2	CC1=CC2=C(C=C1C)N(C3=C(N2)C(=O)NC(=O)N3)CC(C(C(COP(=O)(O)OP(=O)(O)OCC4C(C(C(O4)N5C=NC6=C(N=CN=C65)N)O)O)O)O)O
FMN	CC1=CC2=C(C=C1C)N(C3=NC(=O)NC(=O)C3=N2)CC(C(C(COP(=O)(O)O)O)O)O
GDP	C1=NC2=C(N1C3C(C(C(O3)COP(=O)(O)OP(=O)(O)O)O)O)N=C(NC2=O)N
GDP-alpha-D-mannose	C1=NC2=C(N1C3C(C(C(O3)COP(=O)(O)OP(=O)(O)OC4C(C(C(C(O4)CO)O)O)O)O)O)N=C(NC2=O)N
GMP	C1=NC2=C(N1C3C(C(C(O3)COP(=O)(O)O)O)O)N=C(NC2=O)N
GTP	C1=NC2=C(N1C3C(C(C(O3)COP(=O)(O)OP(=O)(O)OP(=O)(O)O)O)O)N=C(NC2=O)N
Gln-tRNA(Gln)_C20H29N7O12PR(C5H8O6PR)n	
Glu-tRNA(Glu)_C20H28N6O13PR(C5H8O6PR)n	
Gly-tRNA(Gly)_C12H20NO11PR2(C5H8O6PR)n	
H+_p+1	
H2O	O
His-tRNA(His)_C16H24N3O11PR2(C5H8O6PR)n	
IDP	C1=NC2=C(C(=O)N1)N=CN2C3C(C(C(O3)COP(=O)(O)OP(=O)(O)O)O)O
IMP	C1=NC2=C(C(=O)N1)N=CN2C3C(C(C(O3)COP(=O)(O)O)O)O
ITP	C1=NC2=C(C(=O)N1)N=CN2C3C(C(C(O3)COP(=O)(O)OP(=O)(O)OP(=O)(O)O)O)O
Ile-tRNA(Ile)_C21H32N6O11PR(C5H8O6PR)n	
L-2-amino-3-oxobutanoate	CC(=O)C(C(=O)O)N
L-2-aminoadipate	C(CC(C(=O)O)N)CC(=O)O
L-4-hydroxyglutamic semialdehyde	C(C(C=O)O)C(C(=O)O)N
L-alanine	CC(C(=O)O)N
L-allothreonine	CC(C(C(=O)O)N)O
L-allysine	C(CC=O)CC(C(=O)O)N
L-alpha-formylglycine	C(=O)C(C(=O)O)N
L-arabinitol	C(C(C(C(CO)O)O)O)O
L-arabinose	C1C(C(C(C(O1)O)O)O)O
L-arginine	C(CC(C(=O)O)N)CN=C(N)N
L-asparagine	C(C(C(=O)O)N)C(=O)N
L-aspartate	C(C(C(=O)O)N)C(=O)O
L-aspartate 4-semialdehyde	C(C=O)C(C(=O)[O-])[NH3+]
L-citrulline	C(CC(C(=O)O)N)CNC(=O)N
L-cystathionine	C(CSCC(C(=O)O)N)C(C(=O)O)N
L-cysteine	C(C(C(=O)O)N)S
L-cysteinylglycine	C(C(C(=O)NCC(=O)O)N)S
L-gamma-glutamyl phosphate	C(CC(=O)OP(=O)(O)O)C(C(=O)O)N
L-gamma-glutamyl-L-alanine	CC(C(=O)O)NC(=O)CCC(C(=O)O)N
L-gamma-glutamyl-L-cysteine	C(CC(=O)NC(CS)C(=O)O)C(C(=O)O)N
L-glucitol	C(C(C(C(C(CO)O)O)O)O)O
L-glutamate	C(CC(=O)O)C(C(=O)O)N
L-glutamic 5-semialdehyde	C(CC(C(=O)O)N)C=O
L-glutamine	C(CC(=O)N)C(C(=O)O)N
L-glycine	C(C(=O)O)N
L-histidine	C1=C(NC=N1)CC(C(=O)O)N
L-histidinol	C1=C(NC=N1)CC(CO)N
L-histidinol phosphate	C1=C(NC=N1)CC(COP(=O)(O)O)N
L-homocysteine	C(CS)C(C(=O)O)N
L-homoserine	C(CO)C(C(=O)O)N
L-isoleucine	CCC(C)C(C(=O)O)N
L-kynurenine	C1=CC=C(C(=C1)C(=O)CC(C(=O)O)N)N
L-leucine	CC(C)CC(C(=O)O)N
L-lysine	C(CCN)CC(C(=O)O)N
L-methionine	CSCCC(C(=O)O)N
L-phenylalanine	C1=CC=C(C=C1)CC(C(=O)O)N
L-proline	C1CC(NC1)C(=O)O
L-saccharopine	C(CCNC(CCC(=O)O)C(=O)O)CC(C(=O)O)N
L-serine	C(C(C(=O)O)N)O
L-sorbose	C1C(C(C(C(O1)(CO)O)O)O)O
L-threonine	CC(C(C(=O)O)N)O
L-tryptophan	C1=CC=C2C(=C1)C(=CN2)CC(C(=O)O)N
L-tyrosine	C1=CC(=CC=C1CC(C(=O)O)N)O
L-valine	CC(C)C(C(=O)O)N
Leu-tRNA(Leu)_C21H32N6O11PR(C5H8O6PR)n	
Lys-tRNA(Lys)	
Met-tRNA(Met)_C20H30N6O11PSR(C5H8O6PR)n	
N(1)-acetylspermidine	CC(=O)NCCCNCCCCN
N(1)-acetylspermine	CC(=O)NCCCNCCCCNCCCN
N(2)-acetyl-L-ornithine	CC(=O)NC(CCCN)C(=O)O
N(pros)-methyl-L-histidine	CN1C=NC=C1CC(C(=O)O)N
N,N'-diacetylchitobiosyldiphosphodolichol	CC(CCC=C(C)CCC=C(C)CCC=C(C)CCC=C(C)C)CCOP(=O)([O-])OP(=O)([O-])OC1C(C(C(C(O1)CO)OC2C(C(C(C(O2)CO)O)O)NC(=O)C)O)NC(=O)C
N-(5-phospho-beta-D-ribosyl)anthranilate	C1=CC=C(C(=C1)C(=O)O)NC2C(C(C(O2)COP(=O)(O)O)O)O
N-[(R)-4-phosphonopantothenoyl]-L-cysteine	
N-acetyl-D-glucosamine 6-phosphate	CC(=O)NC1C(C(C(OC1O)COP(=O)(O)O)O)O
N-acetyl-L-gamma-glutamyl phosphate	CC(=O)NC(CCC(=O)OP(=O)(O)O)C(=O)O
N-acetyl-L-glutamate	CC(=O)NC(CCC(=O)O)C(=O)O
N-acetyl-alpha-D-glucosamine 1-phosphate	CC(=O)NC1C(C(C(OC1OP(=O)(O)O)CO)O)O
N-acetylputrescine	CC(=O)NCCCCN
N-carbamoyl-L-aspartate	C(C(C(=O)O)NC(=O)N)C(=O)O
N-formyl-L-kynurenine	C1=CC=C(C(=C1)C(=O)CC(C(=O)O)N)NC=O
N-pantothenoylcysteine	CC(C)(CO)C(C(=O)NCCC(=O)NC(CS)C(=O)O)O
NAD	C1=CC(=C[N+](=C1)C2C(C(C(O2)COP(=O)([O-])OP(=O)(O)OCC3C(C(C(O3)N4C=NC5=C(N=CN=C54)N)O)O)O)O)C(=O)N
NADH	C1C=CN(C=C1C(=O)N)C2C(C(C(O2)COP(=O)(O)OP(=O)(O)OCC3C(C(C(O3)N4C=NC5=C(N=CN=C54)N)O)O)O)O
NADP(+)	C1=CC(=C[N+](=C1)C2C(C(C(O2)COP(=O)([O-])OP(=O)([O-])OCC3C(C(C(O3)N4C=NC5=C(N=CN=C54)N)OP(=O)([O-])[O-])O)O)O)C(=O)N
NADPH	C1C=CN(C=C1C(=O)N)C2C(C(C(O2)COP(=O)(O)OP(=O)(O)OCC3C(C(C(O3)N4C=NC5=C(N=CN=C54)N)OP(=O)(O)O)O)O)O
NMN	C1=CC(=C[N+](=C1)C2C(C(C(O2)COP(=O)(O)[O-])O)O)C(=O)N
O-acetyl-L-homoserine	CC(=O)OCCC(C(=O)O)N
O-acetyl-L-serine	CC(=O)OCC(C(=O)O)N
O-acetylcarnitine	CC(=O)OC(CC(=O)[O-])C[N+](C)(C)C
O-phospho-L-homoserine	C(COP(=O)(O)O)C(C(=O)O)N
O-phosphoethanolamine	C(COP(=O)(O)O)N
O-succinyl-L-homoserine	C(COC(=O)CCC(=O)O)C(C(=O)O)N
OHCU	
P(1),P(4)-bis(5'-adenosyl) tetraphosphate	C1=NC(=C2C(=N1)N(C=N2)C3C(C(C(O3)COP(=O)(O)OP(=O)(O)OP(=O)(O)OP(=O)(O)OCC4C(C(C(O4)N5C=NC6=C(N=CN=C65)N)O)O)O)O)N
P(1),P(4)-bis(5'-guanosyl) tetraphosphate	C1=NC2=C(N1C3C(C(C(O3)COP(=O)(O)OP(=O)(O)OP(=O)(O)OP(=O)(O)OCC4C(C(C(O4)N5C=NC6=C5N=C(NC6=O)N)O)O)O)O)N=C(NC2=O)N
P1-(5'-adenosyl),P4-(5'-guanosyl) tetraphosphate_ActiveX VT_ERROR:	
PRPP	C(C1C(C(C(O1)OP(=O)(O)OP(=O)(O)O)O)O)OP(=O)(O)O
Phe-tRNA(Phe)_C19H26NO11PR2(C5H8O6PR)n	
Pro-tRNA(Pro)	
RNA	
S(8)-aminomethyldihydrolipoamide	C(CCC(=O)N)CC(CCSCN)S
S(8)-aminomethyldihydrolipoylprotein	
S(8)-succinyldihydrolipoamide	C(CCC(=O)N)CC(CCSC(=O)CCC(=O)O)S
S-adenosyl-4-methylthio-2-oxobutanoate	C[S+](CCC(=O)C(=O)O)CC1C(C(C(O1)N2C=NC3=C(N=CN=C32)N)O)O
S-adenosyl-L-homocysteine	C1=NC(=C2C(=N1)N(C=N2)C3C(C(C(O3)CSCCC(C(=O)O)N)O)O)N
S-adenosyl-L-methionine	C[S+](CCC(C(=O)[O-])N)CC1C(C(C(O1)N2C=NC3=C(N=CN=C32)N)O)O
S-adenosylmethioninamine	C[S+](CCCN)CC1C(C(C(O1)N2C=NC3=C(N=CN=C32)N)O)O
S-formylglutathione	C(CC(=O)NC(CSC=O)C(=O)NCC(=O)O)C(C(=O)O)N
S-methyl-5-thio-D-ribulose 1-phosphate	CSCC(C(C(=O)COP(=O)(O)O)O)O
S-methyl-5-thio-alpha-D-ribose 1-phosphate	CSCC1C(C(C(O1)OP(=O)(O)O)O)O
S-methyl-L-methionine	C[S+](C)CCC(C(=O)O)N
Ser-tRNA(Ser)_C13H22NO12PR2(C5H8O6PR)n	
TDP	
THF	C1CCOC1
TMP	
TRX1	
TRX1-disulphide	
TTP	CC1=CN(C(=O)NC1=O)C2CC(C(O2)COP(=O)(O)OP(=O)(O)OP(=O)(O)O)O
Thr-tRNA(Thr)_C14H24NO12PR2(C5H8O6PR)n	
Trp-tRNA(Trp)_C26H31N7O11PR(C5H8O6PR)n	
Tyr-tRNA(Tyr)	
UDP	C1=CN(C(=O)NC1=O)C2C(C(C(O2)COP(=O)(O)OP(=O)(O)O)O)O
UDP-D-galactose	C1=CN(C(=O)NC1=O)C2C(C(C(O2)COP(=O)(O)OP(=O)(O)OC3C(C(C(C(O3)CO)O)O)O)O)O
UDP-D-glucose	C1=CN(C(=O)NC1=O)C2C(C(C(O2)COP(=O)(O)OP(=O)(O)OC3C(C(C(C(O3)CO)O)O)O)O)O
UDP-D-glucuronate_ActiveX VT_ERROR:	
UDP-N-acetyl-alpha-D-glucosamine	CC(=O)NC1C(C(C(OC1OP(=O)(O)OP(=O)(O)OCC2C(C(C(O2)N3C=CC(=O)NC3=O)O)O)CO)O)O
UMP	C1=CN(C(=O)NC1=O)C2C(C(C(O2)COP(=O)(O)O)O)O
UTP	C1=CN(C(=O)NC1=O)C2C(C(C(O2)COP(=O)(O)OP(=O)(O)OP(=O)(O)O)O)O
Val-tRNA(Val)_C20H30N6O11PR(C5H8O6PR)n	
acetaldehyde	CC=O
acetate	CC(=O)[O-]
acetoacetate	CC(=O)CC(=O)[O-]
acetoacetyl-ACP	
acetoacetyl-CoA	CC(=O)CC(=O)SCCNC(=O)CCNC(=O)C(C(C)(C)COP(=O)(O)OP(=O)(O)OCC1C(C(C(O1)N2C=NC3=C(N=CN=C32)N)O)OP(=O)(O)O)O
acetyl-ACP	
acetyl-CoA	CC(=O)SCCNC(=O)CCNC(=O)C(C(C)(C)COP(=O)(O)OP(=O)(O)OCC1C(C(C(O1)N2C=NC3=C(N=CN=C32)N)O)OP(=O)(O)O)O
acyl-CoA	
acylglycerone phosphate	C(C(=O)COP(=O)(O)O)OC=O
adenine	C1=NC2=NC=NC(=C2N1)N
adenosine	C1=NC(=C2C(=N1)N(C=N2)C3C(C(C(O3)CO)O)O)N
adenosine 3',5'-bismonophosphate	C1=NC(=C2C(=N1)N(C=N2)C3C(C(C(O3)COP(=O)(O)O)OP(=O)(O)O)O)N
adenylo-succinate	C1=NC(=C2C(=N1)N(C=N2)C3C(C(C(O3)COP(=O)([O-])[O-])O)O)NC(CC(=O)[O-])C(=O)[O-]
allantoate	C(C(=O)[O-])(NC(=O)N)NC(=O)N
allantoin	C1(C(=O)NC(=O)N1)NC(=O)N
alpha,alpha-trehalose 6-phosphate	C(C1C(C(C(C(O1)OC2C(C(C(C(O2)COP(=O)(O)O)O)O)O)O)O)O)O
alpha-D-galactose 1-phosphate	C(C1C(C(C(C(O1)OP(=O)(O)O)O)O)O)O
alpha-D-glucosamine 1-phosphate	C(C1C(C(C(C(O1)OP(=O)(O)O)N)O)O)O
alpha-D-glucosamine 6-phosphate	C(C1C(C(C(C(O1)O)N)O)O)OP(=O)(O)O
alpha-D-mannosyl-beta-D-mannosyldiacetylchitobiosyldiphosphodolichol_C38H68N2O27P2(C5H8)n	
alpha-D-ribose 1-phosphate	C(C1C(C(C(O1)OP(=O)(O)O)O)O)O
aminoacetaldehyde	C(C=O)N
aminoacetone_ActiveX VT_ERROR:	
ammonium	[NH4+]
anthranilate	C1=CC=C(C(=C1)C(=O)O)N
arachidate	CCCCCCCCCCCCCCCCCCCC(=O)O
behenate	CCCCCCCCCCCCCCCCCCCCCC(=O)[O-]
beta-D-fructose 2,6-bisphosphate	C(C1C(C(C(O1)(CO)OP(=O)(O)O)O)O)OP(=O)(O)O
beta-D-mannosyldiacetylchitobiosyldiphosphodolichol	CC(CCC=C(C)CCC=C(C)CCC=C(C)CCC=C(C)C)CCOP(=O)(O)OP(=O)(O)OC1C(C(C(C(O1)CO)OC2C(C(C(C(O2)CO)OC3C(C(C(C(O3)CO)O)O)O)O)NC(=O)C)O)NC(=O)C
beta-alanine	C(CN)C(=O)O
bicarbonate	C(=O)(O)[O-]
biomass	
biotin	C1C2C(C(S1)CCCCC(=O)O)NC(=O)N2
biotinyl-5'-AMP	C1C2C(C(S1)CCCCC(=O)OP(=O)(O)OCC3C(C(C(O3)N4C=NC5=C(N=CN=C54)N)O)O)NC(=O)N2
but-1-ene-1,2,4-tricarboxylic acid	C(CC(=O)O)C(=CC(=O)O)C(=O)O
butanoyl-ACP	
butanoyl-CoA	CCCC(=O)SCCNC(=O)CCNC(=O)C(C(C)(C)COP(=O)(O)OP(=O)(O)OCC1C(C(C(O1)N2C=NC3=C(N=CN=C32)N)O)OP(=O)(O)O)O
butyrate_ActiveX VT_ERROR:	
carbamoyl phosphate	C(=O)(N)OP(=O)(O)O
carbohydrate	
carbon dioxide	C(=O)=O
carboxyacetyl-ACP	
cardiolipin_ActiveX VT_ERROR:	
cellobiose	C(C1C(C(C(C(O1)OC2C(OC(C(C2O)O)O)CO)O)O)O)O
ceramide-1-(C24)	
ceramide-1-(C26)	
ceramide-2'-(C24)	
ceramide-2'-(C26)	
ceramide-2-(C24)	
ceramide-2-(C26)	
ceramide-3-(C24)	
ceramide-3-(C26)	
ceramide-4-(C24)	
ceramide-4-(C26)	
cerotic acid	CCCCCCCCCCCCCCCCCCCCCCCCCC(=O)O
chitin_H2O(C8H13NO5)n	
chitosan_H2O(C6H12NO4)n	
choline	C[N+](C)(C)CCO
choline phosphate	C[N+](C)(C)CCOP(=O)(O)O.[Cl-]
chorismate	C=C(C(=O)O)OC1C=C(C=CC1O)C(=O)O
cis-aconitate	C(C(=CC(=O)O)C(=O)O)C(=O)O
cis-dec-3-enoyl-CoA	
cis-dodec-3-enoyl-CoA	CCCCCCCCC=CCC(=O)SCCNC(=O)CCNC(=O)C(C(C)(C)COP(=O)(O)OP(=O)(O)OCC1C(C(C(O1)N2C=NC3=C(N=CN=C32)N)O)OP(=O)(O)O)O
cis-dodec-5-enoyl-CoA	
cis-hexadec-7-enoyl-CoA	CCCCCCCCC=CCCCCCC(=O)SCCNC(=O)CCNC(=O)C(C(C)(C)COP(=O)([O-])OP(=O)([O-])OCC1C(C(C(O1)N2C=NC3=C(N=CN=C32)N)O)OP(=O)([O-])[O-])O
cis-tetradec-5-enoyl-CoA	CCCCCCCCC=CCCCC(=O)SCCNC(=O)CCNC(=O)C(C(C)(C)COP(=O)(O)OP(=O)(O)OCC1C(C(C(O1)N2C=NC3=C(N=CN=C32)N)O)OP(=O)(O)O)O
cis-tetradec-7-enoyl-CoA	
citrate	C(C(=O)[O-])C(CC(=O)[O-])(C(=O)[O-])O
coenzyme A	CC(C)(COP(=O)(O)OP(=O)(O)OCC1C(C(C(O1)N2C=NC3=C(N=CN=C32)N)O)OP(=O)(O)O)C(C(=O)NCCC(=O)NCCS)O
complex sphingolipid	
coproporphyrinogen III	CC1=C2CC3=C(C(=C(N3)CC4=C(C(=C(N4)CC5=C(C(=C(N5)CC(=C1CCC(=O)O)N2)C)CCC(=O)O)C)CCC(=O)O)CCC(=O)O)C
crotonoyl-CoA	CC=CC(=O)SCCNC(=O)CCNC(=O)C(C(C)(C)COP(=O)(O)OP(=O)(O)OCC1C(C(C(O1)N2C=NC3=C(N=CN=C32)N)O)OP(=O)(O)O)O
cytidine	C1=CN(C(=O)N=C1N)C2C(C(C(O2)CO)O)O
cytosine	C1=C(NC(=O)N=C1)N
dADP	C1C(C(OC1N2C=NC3=C(N=CN=C32)N)COP(=O)(O)OP(=O)(O)O)O
dAMP	C1C(C(OC1N2C=NC3=C(N=CN=C32)N)COP(=O)(O)O)O
dATP	C1C(C(OC1N2C=NC3=C(N=CN=C32)N)COP(=O)(O)OP(=O)(O)OP(=O)(O)O)O
dCDP	C1C(C(OC1N2C=CC(=NC2=O)N)COP(=O)(O)OP(=O)(O)O)O
dCMP	C1C(C(OC1N2C=CC(=NC2=O)N)COP(=O)(O)O)O
dCTP	C1C(C(OC1N2C=CC(=NC2=O)N)COP(=O)(O)OP(=O)(O)OP(=O)(O)O)O
dGDP	C1C(C(OC1N2C=NC3=C2N=C(NC3=O)N)COP(=O)(O)OP(=O)(O)O)O
dGMP	C1C(C(OC1N2C=NC3=C2N=C(NC3=O)N)COP(=O)(O)O)O
dGTP	C1C(C(OC1N2C=NC3=C2N=C(NC3=O)N)COP(=O)(O)OP(=O)(O)OP(=O)(O)O)O
dIDP_ActiveX VT_ERROR:	
dITP	C1C(C(OC1N2C=NC3=C2N=CNC3=O)COP(=O)(O)OP(=O)(O)OP(=O)(O)O)O
dTDP	CC1=CN(C(=O)NC1=O)C2CC(C(O2)COP(=O)(O)OP(=O)(O)O)O
dTMP	CC1=CN(C(=O)NC1=O)C2CC(C(O2)COP(=O)(O)O)O
dTTP	CC1=CN(C(=O)NC1=O)C2CC(C(O2)COP(=O)(O)OP(=O)(O)OP(=O)(O)O)O
dUDP	C1C(C(OC1N2C=CC(=O)NC2=O)COP(=O)(O)OP(=O)(O)O)O
dUMP	C1C(C(OC1N2C=CC(=O)NC2=O)COP(=O)(O)O)O
dUTP	C1C(C(OC1N2C=CC(=O)NC2=O)COP(=O)(O)OP(=O)(O)OP(=O)(O)O)O
deamido-NAD(+)	C1=CC(=C[N+](=C1)C2C(C(C(O2)COP(=O)(O)OP(=O)(O)OCC3C(C(C(O3)N4C=NC5=C(N=CN=C54)N)O)O)O)O)C(=O)O
decanal	CCCCCCCCCC=O
decane	CCCCCCCCCC
decanoate	CCCCCCCCCC(=O)[O-]
decanol	CCCCCCCCCCO
decanoyl-CoA	CCCCCCCCCC(=O)SCCNC(=O)CCNC(=O)C(C(C)(C)COP(=O)(O)OP(=O)(O)OCC1C(C(C(O1)N2C=NC3=C(N=CN=C32)N)O)OP(=O)(O)O)O
decaprenyl diphosphate	CC(=CCCC(=CCCC(=CCCC(=CCCC(=CCCC(=CCCC(=CCCC(=CCCC(=CCCC(=CCOP(=O)(O)OP(=O)(O)O)C)C)C)C)C)C)C)C)C)C
dehydro-D-arabinono-1,4-lactone	C(C1C(=C(C(=O)O1)O)O)O
dehydroalanine	C=C(C(=O)O)N
deoxycytidine	C1C(C(OC1N2C=CC(=NC2=O)N)CO)O
dethiobiotin	CC1C(NC(=O)N1)CCCCCC(=O)O
dibutyrin	CCCC(=O)OCC(COC(=O)CCC)O
diglyceride_ActiveX VT_ERROR:	
dihydrofolic acid	C1C(=NC2=C(N1)N=C(NC2=O)N)CNC3=CC=C(C=C3)C(=O)NC(CCC(=O)O)C(=O)O
dihydrolipoamide	C(CCC(=O)N)CC(CCS)S
dihydrolipoylprotein	
dihydroxyacetone phosphate	C(C(=O)COP(=O)(O)O)O
diphosphate	[O-]P(=O)([O-])OP(=O)([O-])[O-]
docosanoyl-CoA	CCCCCCCCCCCCCCCCCCCCCC(=O)SCCNC(=O)CCNC(=O)C(C(C)(C)COP(=O)(O)OP(=O)(O)OCC1C(C(C(O1)N2C=NC3=C(N=CN=C32)N)O)OP(=O)(O)O)O
docosaprenyl diphosphate	CC(=CCCC(=CCCC(=CCCC(=CCCC(=CCCC(=CCCC(=CCCC(=CCCC(=CCCC(=CCCC(=CCCC(=CCCC(=CCCC(=CCCC(=CCCC(=CCCC(=CCCC(=CCCC(=CCCC(=CCCC(=CCCC(=CCOP(=O)(O)OP(=O)(O)O)C)C)C)C)C)C)C)C)C)C)C)C)C)C)C)C)C)C)C)C)C)C
dodecanal	CCCCCCCCCCCC=O
dodecane	CCCCCCCCCCCC
dodecanol	CCCCCCCCCCCCO
dodecaprenyl diphosphate	CC(=CCCC(=CCCC(=CCCC(=CCCC(=CCCC(=CCCC(=CCCC(=CCCC(=CCCC(=CCCC(=CCCC(=CCOP(=O)(O)OP(=O)(O)O)C)C)C)C)C)C)C)C)C)C)C)C
dolichol	
dolichyl D-mannosyl phosphate_C26H47O9P(C5H8)n	
dolichyl phosphate_C20H37O4P(C5H8)n	
episterol	CC(C)C(=C)CCC(C)C1CCC2C1(CCC3C2=CCC4C3(CCC(C4)O)C)C
episteryl oleate	CCCCCCCCC=CCCCCCCCC(=O)OC1CCC2(C3CCC4(C(C3=CCC2C1)CCC4C(C)CCC(=C)C(C)C)C)C
episteryl palmitoleate	CCCCCCC=CCCCCCCCC(=O)OC1CCC2(C3CCC4(C(C3=CCC2C1)CCC4C(C)CCC(=C)C(C)C)C)C
ergosta-5,7,22,24(28)-tetraen-3beta-ol	CC(C)C(=C)C=CC(C)C1CCC2C1(CCC3C2=CC=C4C3(CCC(C4)O)C)C
ergosta-5,7,24(28)-trien-3beta-ol	CC(C)C(=C)CCC(C)C1CCC2C1(CCC3C2=CC=C4C3(CCC(C4)O)C)C
ergosterol	CC(C)C(C)C=CC(C)C1CCC2C1(CCC3C2=CC=C4C3(CCC(C4)O)C)C
ergosterol 3-beta-D-glucoside	
ergosteryl oleate	CCCCCCCCC=CCCCCCCCC(=O)OC1CCC2(C3CCC4(C(C3=CC=C2C1)CCC4C(C)C=CC(C)C(C)C)C)C
ergosteryl palmitoleate	CCCCCCC=CCCCCCCCC(=O)OC1CCC2(C3CCC4(C(C3=CC=C2C1)CCC4C(C)C=CC(C)C(C)C)C)C
erythritol	C(C(C(CO)O)O)O
erythro-4-hydroxy-L-glutamic acid	C(C(C(=O)O)N)C(C(=O)O)O
erythrose	C(C(C(C=O)O)O)O
ethanol	CCO
ethanolamine	C(CO)N
fMet-tRNA(fMet)_ActiveX VT_ERROR:	
farnesyl diphosphate	CC(=CCCC(=CCCC(=CCOP(=O)(O)OP(=O)(O)O)C)C)C
fatty acid	
fecosterol	CC(C)C(=C)CCC(C)C1CCC2C1(CCC3=C2CCC4C3(CCC(C4)O)C)C
fecosteryl oleate	CCCCCCCCC=CCCCCCCCC(=O)OC1CCC2(C(C1)CCC3=C2CCC4(C3CCC4C(C)CCC(=C)C(C)C)C)C
fecosteryl palmitoleate	CCCCCCC=CCCCCCCCC(=O)OC1CCC2(C(C1)CCC3=C2CCC4(C3CCC4C(C)CCC(=C)C(C)C)C)C
ferricytochrome c	
ferrocytochrome c	
ferroheme b	CC1=C(C2=CC3=NC(=CC4=C(C(=C([N-]4)C=C5C(=C(C(=N5)C=C1[N-]2)C=C)C)C=C)C)C(=C3CCC(=O)O)C)CCC(=O)O.[Fe]
folate_ActiveX VT_ERROR:	
formaldehyde	C=O
formate	C(=O)[O-]
fumarate	C(=CC(=O)[O-])C(=O)[O-]
gamma-aminobutyrate	C(CC(=O)O)CN
geranyl diphosphate	CC(=CCCC(=CCOP(=O)(O)OP(=O)(O)O)C)C
geranylgeranyl diphosphate	CC(=CCCC(=CCCC(=CCCC(=CCOP(=O)(O)OP(=O)(O)O)C)C)C)C
glutaryl-CoA	CC(C)(COP(=O)(O)OP(=O)(O)OCC1C(C(C(O1)N2C=NC3=C(N=CN=C32)N)O)OP(=O)(O)O)C(C(=O)NCCC(=O)NCCSC(=O)CCCC(=O)O)O
glutathione	C(CC(=O)NC(CS)C(=O)NCC(=O)O)C(C(=O)O)N
glutathione disulfide	C(CC(=O)NC(CSSCC(C(=O)NCC(=O)O)NC(=O)CCC(C(=O)O)N)C(=O)NCC(=O)O)C(C(=O)O)N
glyceraldehyde 3-phosphate	C(C(C=O)O)OP(=O)(O)O
glycerol	C(C(CO)O)O
glycerol 3-phosphate	C(C(COP(=O)(O)O)O)O
glycerone	C(C(=O)CO)O
glycogen	C(C1C(C(C(C(O1)OCC2C(C(C(C(O2)OC3C(OC(C(C3O)O)O)CO)O)O)OC4C(C(C(C(O4)CO)O)O)O)O)O)O)O
glycolaldehyde	C(C=O)O
glyoxylate	C(=O)C(=O)[O-]
guanine	C1=NC2=C(N1)C(=O)NC(=N2)N
guanosine	C1=NC2=C(N1C3C(C(C(O3)CO)O)O)N=C(NC2=O)N
heme a	CC1=C(C2=CC3=NC(=CC4=C(C(=C([N-]4)C=C5C(=C(C(=N5)C=C1[N-]2)C(CCC=C(C)CCC=C(C)CCC=C(C)C)O)C)C=O)CCC(=O)O)C(=C3C)CCC(=O)O)C=C.[Fe]
heme o	CC1=C(C2=CC3=NC(=CC4=C(C(=C([N-]4)C=C5C(=C(C(=N5)C=C1[N-]2)C=C)C)C(CCC=C(C)CCC=C(C)CCC=C(C)C)O)C)C(=C3CCC(=O)O)C)CCC(=O)O.[Fe+2]
henicosaprenyl diphosphate	CC(=CCCC(=CCCC(=CCCC(=CCCC(=CCCC(=CCCC(=CCCC(=CCCC(=CCCC(=CCCC(=CCCC(=CCCC(=CCCC(=CCCC(=CCCC(=CCCC(=CCCC(=CCCC(=CCCC(=CCCC(=CCOP(=O)(O)OP(=O)(O)O)C)C)C)C)C)C)C)C)C)C)C)C)C)C)C)C)C)C)C)C)C
heptadecaprenyl diphosphate	CC(=CCCC(=CCCC(=CCCC(=CCCC(=CCCC(=CCCC(=CCCC(=CCCC(=CCCC(=CCCC(=CCCC(=CCCC(=CCCC(=CCCC(=CCCC(=CCCC(=CCOP(=O)(O)OP(=O)(O)O)C)C)C)C)C)C)C)C)C)C)C)C)C)C)C)C)C
heptaprenyl diphosphate	CC(=CCCC(=CCCC(=CCCC(=CCCC(=CCCC(=CCCC(=CCOP(=O)(O)OP(=O)(O)O)C)C)C)C)C)C)C
hexacosanoyl-CoA	CCCCCCCCCCCCCCCCCCCCCCCCCC(=O)SCCNC(=O)CCNC(=O)C(C(C)(C)COP(=O)(O)OP(=O)(O)OCC1C(C(C(O1)N2C=NC3=C(N=CN=C32)N)O)OP(=O)(O)O)O
hexadec-2-enoyl-CoA	CCCCCCCCCCCCCC=CC(=O)SCCNC(=O)CCNC(=O)C(C(C)(C)COP(=O)(O)OP(=O)(O)OCC1C(C(C(O1)N2C=NC3=C(N=CN=C32)N)O)OP(=O)(O)O)O
hexadecanal	CCCCCCCCCCCCCCCC=O
hexadecane	CCCCCCCCCCCCCCCC
hexadecanol	CCCCCCCCCCCCCCCCO
hexadecaprenyl diphosphate	CC(=CCCC(=CCCC(=CCCC(=CCCC(=CCCC(=CCCC(=CCCC(=CCCC(=CCCC(=CCCC(=CCCC(=CCCC(=CCCC(=CCCC(=CCCC(=CCOP(=O)(O)OP(=O)(O)O)C)C)C)C)C)C)C)C)C)C)C)C)C)C)C)C
hexanoate	CCCCCC(=O)[O-]
hexanoyl-ACP	
hexanoyl-CoA	CCCCCC(=O)SCCNC(=O)CCNC(=O)C(C(C)(C)COP(=O)(O)OP(=O)(O)OCC1C(C(C(O1)N2C=NC3=C(N=CN=C32)N)O)OP(=O)(O)O)O
hexaprenyl diphosphate	CC(=CCCC(=CCCC(=CCCC(=CCCC(=CCCC(=CCOP(=O)(O)OP(=O)(O)O)C)C)C)C)C)C
homocitrate	C(CC(CC(=O)O)(C(=O)O)O)C(=O)O
homogentisate	C1=CC(=C(C=C1O)CC(=O)O)O
homoisocitrate	C(CC(=O)O)C(C(C(=O)O)O)C(=O)O
hydrogen peroxide	OO
hydrogen sulfide	S
hydroxypyruvate	C(C(=O)C(=O)O)O
hypoxanthine	C1=NC2=C(N1)C(=O)NC=N2
icosanoyl-CoA	CCCCCCCCCCCCCCCCCCCC(=O)SCCNC(=O)CCNC(=O)C(C(C)(C)COP(=O)(O)OP(=O)(O)OCC1C(C(C(O1)N2C=NC3=C(N=CN=C32)N)O)OP(=O)(O)O)O
icosaprenyl diphosphate	CC(=CCCC(=CCCC(=CCCC(=CCCC(=CCCC(=CCCC(=CCCC(=CCCC(=CCCC(=CCCC(=CCCC(=CCCC(=CCCC(=CCCC(=CCCC(=CCCC(=CCCC(=CCCC(=CCCC(=CCOP(=O)(O)OP(=O)(O)O)C)C)C)C)C)C)C)C)C)C)C)C)C)C)C)C)C)C)C)C
indole-3-acetate	C1=CC=C2C(=C1)C(=CN2)CC(=O)[O-]
indole-3-pyruvate	C1=CC=C2C(=C1)C(=CN2)CC(=O)C(=O)O
inosine	C1=NC2=C(C(=O)N1)N=CN2C3C(C(C(O3)CO)O)O
inositol phosphomannosylinositol phosphoceramide A (C24)	CCCCCCCCCCCCCCCCCCCCCCCC(=O)NC(COP(=O)(O)OC1C(C(C(C(C1OC2C(C(C(C(O2)COP(=O)(O)OC3C(C(C(C(C3O)O)O)O)O)O)O)O)O)O)O)O)C(CCCCCCCCCCCCCCC)O
inositol phosphomannosylinositol phosphoceramide A (C26)	CCCCCCCCCCCCCCCCCCCCCCCCCC(=O)NC(COP(=O)(O)OC1C(C(C(C(C1OC2C(C(C(C(O2)COP(=O)(O)OC3C(C(C(C(C3O)O)O)O)O)O)O)O)O)O)O)O)C(CCCCCCCCCCCCCCCCC)O
inositol phosphomannosylinositol phosphoceramide B (C24)	CCCCCCCCCCCCCCCCCCCCCCCC(=O)NC(COP(=O)(O)OC1C(C(C(C(C1OC2C(C(C(C(O2)COP(=O)(O)OC3C(C(C(C(C3O)O)O)O)O)O)O)O)O)O)O)O)C(C(CCCCCCCCCCCCCC)O)O
inositol phosphomannosylinositol phosphoceramide B (C26)	CCCCCCCCCCCCCCCCCCCCCCCCCC(=O)NC(COP(=O)(O)OC1C(C(C(C(C1OC2C(C(C(C(O2)COP(=O)(O)OC3C(C(C(C(C3O)O)O)O)O)O)O)O)O)O)O)O)C(C(CCCCCCCCCCCCCCCC)O)O
inositol phosphomannosylinositol phosphoceramide B' (C24)	CCCCCCCCCCCCCCCCCCCCCCC(C(=O)NC(COP(=O)(O)OC1C(C(C(C(C1OC2C(C(C(C(O2)COP(=O)(O)OC3C(C(C(C(C3O)O)O)O)O)O)O)O)O)O)O)O)C(CCCCCCCCCCCCCCC)O)O
inositol phosphomannosylinositol phosphoceramide B' (C26)	CCCCCCCCCCCCCCCCCCCCCCCCC(C(=O)NC(COP(=O)(O)OC1C(C(C(C(C1OC2C(C(C(C(O2)COP(=O)(O)OC3C(C(C(C(C3O)O)O)O)O)O)O)O)O)O)O)O)C(CCCCCCCCCCCCCCCCC)O)O
inositol phosphomannosylinositol phosphoceramide C (C24)	CCCCCCCCCCCCCCCCCCCCCCC(C(=O)NC(COP(=O)(O)OC1C(C(C(C(C1OC2C(C(C(C(O2)COP(=O)(O)OC3C(C(C(C(C3O)O)O)O)O)O)O)O)O)O)O)O)C(C(CCCCCCCCCCCCCC)O)O)O
inositol phosphomannosylinositol phosphoceramide C (C26)	CCCCCCCCCCCCCCCCCCCCCCCCC(C(=O)NC(COP(=O)([O-])OC1C(C(C(C(C1OC2C(C(C(C(O2)COP(=O)([O-])OC3C(C(C(C(C3O)O)O)O)O)O)O)O)O)O)O)O)C(C(CCCCCCCCCCCCCC)O)O)O
inositol phosphomannosylinositol phosphoceramide D (C24)	CCCCCCCCCCCCCCCCCCCCCC(C(C(=O)NC(COP(=O)(O)OC1C(C(C(C(C1OC2C(C(C(C(O2)COP(=O)(O)OC3C(C(C(C(C3O)O)O)O)O)O)O)O)O)O)O)O)C(C(CCCCCCCCCCCCCC)O)O)O)O
inositol phosphomannosylinositol phosphoceramide D (C26)	CCCCCCCCCCCCCCCCCCCCCCCC(C(C(=O)NC(COP(=O)(O)OC1C(C(C(C(C1OC2C(C(C(C(O2)COP(=O)(O)OC3C(C(C(C(C3O)O)O)O)O)O)O)O)O)O)O)O)C(C(CCCCCCCCCCCCCCCC)O)O)O)O
inositol-P-ceramide A (C24)	CCCCCCCCCCCCCCCCCCCCCCCC(=O)NC(COP(=O)([O-])OC1C(C(C(C(C1O)O)O)O)O)C(CCCCCCCCCCCCCCC)O
inositol-P-ceramide A (C26)	CCCCCCCCCCCCCCCCCCCCCCCCCC(=O)NC(COP(=O)(O)OC1C(C(C(C(C1O)O)O)O)O)C(CCCCCCCCCCCCCCC)O
inositol-P-ceramide A-(C24)	
inositol-P-ceramide A-(C26)	
inositol-P-ceramide B (C24)	CCCCCCCCCCCCCCCCCCCCCCCC(=O)NC(COP(=O)(O)OC1C(C(C(C(C1O)O)O)O)O)C(C(CCCCCCCCCCCCCC)O)O
inositol-P-ceramide B (C26)	CCCCCCCCCCCCCCCCCCCCCCCCCC(=O)NC(COP(=O)(O)OC1C(C(C(C(C1O)O)O)O)O)C(C(CCCCCCCCCCCCCC)O)O
inositol-P-ceramide B' (C24)	CCCCCCCCCCCCCCCCCCCCCCC(C(=O)NC(COP(=O)(O)OC1C(C(C(C(C1O)O)O)O)O)C(CCCCCCCCCCCCCCC)O)O
inositol-P-ceramide B' (C26)	CCCCCCCCCCCCCCCCCCCCCCCCC(C(=O)NC(COP(=O)(O)OC1C(C(C(C(C1O)O)O)O)O)C(CCCCCCCCCCCCCCC)O)O
inositol-P-ceramide B'-(C24)	
inositol-P-ceramide B'-(C26)	
inositol-P-ceramide B-(C24)	
inositol-P-ceramide B-(C26)	
inositol-P-ceramide C (C24)	CCCCCCCCCCCCCCCCCCCCCCC(C(=O)NC(COP(=O)(O)OC1C(C(C(C(C1O)O)O)O)O)C(C(CCCCCCCCCCCCCC)O)O)O
inositol-P-ceramide C (C26)	CCCCCCCCCCCCCCCCCCCCCCCCC(C(=O)NC(COP(=O)(O)OC1C(C(C(C(C1O)O)O)O)O)C(C(CCCCCCCCCCCCCC)O)O)O
inositol-P-ceramide C-(C24)	
inositol-P-ceramide C-(C26)	
inositol-P-ceramide D (C24)	CCCCCCCCCCCCCCCCCCCCCC(C(C(=O)NC(COP(=O)([O-])OC1C(C(C(C(C1O)O)O)O)O)C(C(CCCCCCCCCCCCCC)O)O)O)O
inositol-P-ceramide D (C26)	CCCCCCCCCCCCCCCCCCCCCCCC(C(C(=O)NC(COP(=O)([O-])OC1C(C(C(C(C1O)O)O)O)O)C(C(CCCCCCCCCCCCCC)O)O)O)O
inositol-P-ceramide D-(C24)	
inositol-P-ceramide D-(C26)	
ion	
iron	[Fe]
isoamyl acetate_ActiveX VT_ERROR:	
isoamylol	CC(C)CCO
isocitrate	C(C(C(C(=O)O)O)C(=O)O)C(=O)O
isopentenyl diphosphate	CC(=C)CCOP(=O)(O)OP(=O)(O)O
itaconate	C=C(CC(=O)O)C(=O)O
itaconyl-CoA	CC(C)(COP(=O)(O)OP(=O)(O)OCC1C(C(C(O1)N2C=NC3=C(N=CN=C32)N)O)OP(=O)(O)O)C(C(=O)NCCC(=O)NCCSC(=O)CC(=C)C(=O)O)O
keto-phenylpyruvate	C1=CC=C(C=C1)CC(=O)C(=O)[O-]
kynurenic acid	C1=CC=C2C(=C1)C(=O)C=C(N2)C(=O)O
lanosterol	CC(CCC=C(C)C)C1CCC2(C1(CCC3=C2CCC4C3(CCC(C4(C)C)O)C)C)C
lanosteryl oleate	CCCCCCCCC=CCCCCCCCC(=O)OC1CCC2(C(C1(C)C)CCC3=C2CCC4(C3(CCC4C(C)CCC=C(C)C)C)C)C
lanosteryl palmitoleate	CCCCCCC=CCCCCCCCC(=O)OC1CCC2(C(C1(C)C)CCC3=C2CCC4(C3(CCC4C(C)CCC=C(C)C)C)C)C
laurate	CCCCCCCCCCCC(=O)[O-]
lauroyl-CoA	CCCCCCCCCCCC(=O)SCCNC(=O)CCNC(=O)C(C(C)(C)COP(=O)(O)OP(=O)(O)OCC1C(C(C(O1)N2C=NC3=C(N=CN=C32)N)O)OP(=O)(O)O)O
leukotriene A4	CCCCCC=CCC=CC=CC=CC1C(O1)CCCC(=O)O
leukotriene B4	CCCCCC=CCC(C=CC=CC=CC(CCCC(=O)O)O)O
lignoceric acid	CCCCCCCCCCCCCCCCCCCCCCCC(=O)O
linoleate	CCCCCC=CCC=CCCCCCCCC(=O)O
linoleoyl-CoA	CCCCCC=CCC=CCCCCCCCC(=O)SCCNC(=O)CCNC(=O)C(C(C)(C)COP(=O)(O)OP(=O)(O)OCC1C(C(C(O1)N2C=NC3=C(N=CN=C32)N)O)OP(=O)(O)O)O
lipid	
lipids	
lipoamide	C1CSSC1CCCCC(=O)N
lipoylprotein_C12H18N2O4S2R2(C2H2NOR)n	
malonyl-CoA	CC(C)(COP(=O)(O)OP(=O)(O)OCC1C(C(C(O1)N2C=NC3=C(N=CN=C32)N)O)OP(=O)(O)O)C(C(=O)NCCC(=O)NCCSC(=O)CC(=O)O)O
maltose	C(C1C(C(C(C(O1)OC2C(OC(C(C2O)O)O)CO)O)O)O)O
mannan	C(C1C(C(C(C(O1)OC2C(OC(C(C2O)O)OC3C(OC(C(C3O)O)OC4C(OC(C(C4O)O)O)CO)CO)CO)O)O)O)O
mannose-(1D-myo-inositol 1-phosphate)2	C(C1C(C(C(C(O1)OC2C(C(C(C(C2OP(=O)(O)O)O)O)O)O)O)O)O)OP(=O)(O)OC3C(C(C(C(C3O)O)O)O)O
mannose-1D-myo-inositol 1-phosphate	C(C1C(C(C(C(O1)OC2C(C(C(C(C2OP(=O)(O)O)O)O)O)O)O)O)O)O
mannosylinositol phosphorylceramide A (C24)	CCCCCCCCCCCCCCCCCCCCCCCC(=O)NC(COP(=O)(O)OC1C(C(C(C(C1OC2C(C(C(C(O2)CO)O)O)O)O)O)O)O)C(CCCCCCCCCCCCCCC)O
mannosylinositol phosphorylceramide A (C26)	CCCCCCCCCCCCCCCCCCCCCCCCCC(=O)NC(COP(=O)(O)OC1C(C(C(C(C1OC2C(C(C(C(O2)CO)O)O)O)O)O)O)O)C(CCCCCCCCCCCCCCCCC)O
mannosylinositol phosphorylceramide B (C24)	CCCCCCCCCCCCCCCCCCCCCCCC(=O)NC(COP(=O)(O)OC1C(C(C(C(C1OC2C(C(C(C(O2)CO)O)O)O)O)O)O)O)C(C(CCCCCCCCCCCCCC)O)O
mannosylinositol phosphorylceramide B (C26)	CCCCCCCCCCCCCCCCCCCCCCCCCC(=O)NC(COP(=O)(O)OC1C(C(C(C(C1OC2C(C(C(C(O2)CO)O)O)O)O)O)O)O)C(C(CCCCCCCCCCCCCCCC)O)O
mannosylinositol phosphorylceramide B' (C24)	CCCCCCCCCCCCCCCCCCCCCCC(C(=O)NC(COP(=O)(O)OC1C(C(C(C(C1OC2C(C(C(C(O2)CO)O)O)O)O)O)O)O)C(CCCCCCCCCCCCCCC)O)O
mannosylinositol phosphorylceramide B' (C26)	CCCCCCCCCCCCCCCCCCCCCCCCC(C(=O)NC(COP(=O)(O)OC1C(C(C(C(C1OC2C(C(C(C(O2)CO)O)O)O)O)O)O)O)C(CCCCCCCCCCCCCCCCC)O)O
mannosylinositol phosphorylceramide C (C24)	CCCCCCCCCCCCCCCCCCCCCCC(C(=O)NC(COP(=O)(O)OC1C(C(C(C(C1OC2C(C(C(C(O2)CO)O)O)O)O)O)O)O)C(C(CCCCCCCCCCCCCC)O)O)O
mannosylinositol phosphorylceramide C (C26)	CCCCCCCCCCCCCCCCCCCCCCCCC(C(=O)NC(COP(=O)(O)OC1C(C(C(C(C1OC2C(C(C(C(O2)CO)O)O)O)O)O)O)O)C(C(CCCCCCCCCCCCCCCC)O)O)O
mannosylinositol phosphorylceramide D (C24)	CCCCCCCCCCCCCCCCCCCCCC(C(C(=O)NC(COP(=O)(O)OC1C(C(C(C(C1OC2C(C(C(C(O2)CO)O)O)O)O)O)O)O)C(C(CCCCCCCCCCCCCC)O)O)O)O
mannosylinositol phosphorylceramide D (C26)	CCCCCCCCCCCCCCCCCCCCCCCC(C(C(=O)NC(COP(=O)(O)OC1C(C(C(C(C1OC2C(C(C(C(O2)CO)O)O)O)O)O)O)O)C(C(CCCCCCCCCCCCCCCC)O)O)O)O
melibiose	C(C1C(C(C(C(O1)OCC2C(C(C(C(O2)O)O)O)O)O)O)O)O
methanethiol	CS
methylglyoxal	CC(=O)C=O
monobutyrate	
monolysocardiolipin	
myo-inositol	C1(C(C(C(C(C1O)O)O)O)O)O
myo-inositol 1,3,4,5,6-pentakisphosphate_ActiveX VT_ERROR:	
myo-inositol hexakisphosphate	C1(C(C(C(C(C1OP(=O)(O)O)OP(=O)(O)O)OP(=O)(O)O)OP(=O)(O)O)OP(=O)(O)O)OP(=O)(O)O
myristate	CCCCCCCCCCCCCC(=O)O
myristoyl-CoA	CCCCCCCCCCCCCC(=O)SCCNC(=O)CCNC(=O)C(C(C)(C)COP(=O)(O)OP(=O)(O)OCC1C(C(C(O1)N2C=NC3=C(N=CN=C32)N)O)OP(=O)(O)O)O
nicotinamide	C1=CC(=CN=C1)C(=O)N
nicotinamide ribose	C1=CC(=C[N+](=C1)C2C(C(C(O2)CO)O)O)C(=O)N
nicotinate	C1=CC(=CN=C1)C(=O)[O-]
nicotinate D-ribonucleoside_ActiveX VT_ERROR:	
nicotinate D-ribonucleotide	C1=CC(=C[N+](=C1)C2C(C(C(O2)COP(=O)(O)O)O)O)C(=O)O
nicotinic acid D-ribonucleotide	C1=CC(=C[N+](=C1)C2C(C(C(O2)COP(=O)(O)O)O)O)C(=O)O
nonadecaprenyl diphosphate	CC(=CCCC(=CCCC(=CCCC(=CCCC(=CCCC(=CCCC(=CCCC(=CCCC(=CCCC(=CCCC(=CCCC(=CCCC(=CCCC(=CCCC(=CCCC(=CCCC(=CCCC(=CCCC(=CCOP(=O)(O)OP(=O)(O)O)C)C)C)C)C)C)C)C)C)C)C)C)C)C)C)C)C)C)C
nonaprenyl 4-hydroxybenzoate	CC(=CCCC(=CCCC(=CCCC(=CCCC(=CCCC(=CCCC(=CCCC(=CCCC(=CCOC(=O)C1=CC=C(C=C1)O)C)C)C)C)C)C)C)C)C
nonaprenyl diphosphate	CC(=CCCC(=CCCC(=CCCC(=CCCC(=CCCC(=CCCC(=CCCC(=CCCC(=CCOP(=O)(O)OP(=O)(O)O)C)C)C)C)C)C)C)C)C
octadec-9-ynoyl-CoA	CCCCCCCCC#CCCCCCCCC(=O)SCCNC(=O)CCNC(=O)C(C(C)(C)COP(=O)(O)OP(=O)(O)OCC1C(C(C(O1)N2C=NC3=C(N=CN=C32)N)O)OP(=O)(O)O)O
octadecaprenyl diphosphate	CC(=CCCC(=CCCC(=CCCC(=CCCC(=CCCC(=CCCC(=CCCC(=CCCC(=CCCC(=CCCC(=CCCC(=CCCC(=CCCC(=CCCC(=CCCC(=CCCC(=CCCC(=CCOP(=O)(O)OP(=O)(O)O)C)C)C)C)C)C)C)C)C)C)C)C)C)C)C)C)C)C
octanoate	CCCCCCCC(=O)[O-]
octanoyl-ACP	
octanoyl-CoA	CCCCCCCC(=O)SCCNC(=O)CCNC(=O)C(C(C)(C)COP(=O)(O)OP(=O)(O)OCC1C(C(C(O1)N2C=NC3=C(N=CN=C32)N)O)OP(=O)(O)O)O
octaprenyl diphosphate	CC(=CCCC(=CCCC(=CCCC(=CCCC(=CCCC(=CCCC(=CCCC(=CCOP(=O)(O)OP(=O)(O)O)C)C)C)C)C)C)C)C
oleate	CCCCCCCCC=CCCCCCCCC(=O)O
oleoyl-CoA	CCCCCCCCC=CCCCCCCCC(=O)SCCNC(=O)CCNC(=O)C(C(C)(C)COP(=O)(O)OP(=O)(O)OCC1C(C(C(O1)N2C=NC3=C(N=CN=C32)N)O)OP(=O)(O)O)O
ornithine	C(CC(C(=O)O)N)CN
orotate	C1=C(NC(=O)NC1=O)C(=O)[O-]
orotidine 5'-(dihydrogen phosphate)	C1=C(N(C(=O)NC1=O)C2C(C(C(O2)COP(=O)(O)O)O)O)C(=O)O
oxaloacetate	C(C(=O)C(=O)O)C(=O)O
oxygen	O=O
palmitate	CCCCCCCCCCCCCCCC(=O)O
palmitoleate	CCCCCCC=CCCCCCCCC(=O)[O-]
palmitoleoyl-CoA	CCCCCCC=CCCCCCCCC(=O)SCCNC(=O)CCNC(=O)C(C(C)(C)COP(=O)(O)OP(=O)(O)OCC1C(C(C(O1)N2C=NC3=C(N=CN=C32)N)O)OP(=O)(O)O)O
palmitoyl-CoA	CCCCCCCCCCCCCCCC(=O)SCCNC(=O)CCNC(=O)C(C(C)(C)COP(=O)(O)OP(=O)(O)OCC1C(C(C(O1)N2C=NC3=C(N=CN=C32)N)O)OP(=O)(O)O)O
pantetheine 4'-phosphate	CC(C)(COP(=O)(O)O)C(C(=O)NCCC(=O)NCCS)O
pantetheine_ActiveX VT_ERROR:	
pectin_ActiveX VT_ERROR:	
pentadecaprenyl diphosphate	CC(=CCCC(=CCCC(=CCCC(=CCCC(=CCCC(=CCCC(=CCCC(=CCCC(=CCCC(=CCCC(=CCCC(=CCCC(=CCCC(=CCCC(=CCOP(=O)(O)OP(=O)(O)O)C)C)C)C)C)C)C)C)C)C)C)C)C)C)C
pentaprenyl diphosphate	CC(=CCCC(=CCCC(=CCCC(=CCCC(=CCOP(=O)(O)OP(=O)(O)O)C)C)C)C)C
phenylacetaldehyde	C1=CC=C(C=C1)CC=O
phosphate	[O-]P(=O)([O-])[O-]
phosphatidate_ActiveX VT_ERROR:	
phosphatidyl-L-serine	
phosphatidyl-N,N-dimethylethanolamine	
phosphatidyl-N-methylethanolamine_ActiveX VT_ERROR:	
phosphatidylcholine	
phosphatidylethanolamine	CC(=O)OCC(COP(=O)(O)OCCN)OC(=O)C
phosphatidylglycerol_ActiveX VT_ERROR:	
phosphoenolpyruvate	C=C(C(=O)O)OP(=O)(O)O
phosphoribosyl-carboxy-aminoimidazole	C1=NC(=C(N1C2C(C(C(O2)COP(=O)([O-])[O-])O)O)N)C(=O)[O-]
phosphoribosyl-formamido-carboxamide	
phytosphingosine	CCCCCCCCCCCCCCC(C(C(CO)N)O)O
phytosphingosine 1-phosphate	CCCCCCCCCCCCCCC(C(C(COP(=O)(O)O)N)O)O
pimeloyl-CoA	CC(C)(COP(=O)(O)OP(=O)(O)OCC1C(C(C(O1)N2C=NC3=C(N=CN=C32)N)O)OP(=O)(O)O)C(C(=O)NCCC(=O)NCCSC(=O)CCCCCC(=O)O)O
polysulphur	
porphobilinogen	C1=C(C(=C(N1)CN)CC(=O)O)CCC(=O)O
potassium_K.H	
precorrin-2	CC1(C(C2=CC3=NC(=CC4=C(C(=C(N4)CC5=C(C(=C(N5)C=C1N2)CC(=O)O)CCC(=O)O)CCC(=O)O)CC(=O)O)C(C3(C)CC(=O)O)CCC(=O)O)CCC(=O)O)CC(=O)O
prenyl diphosphate	CC(=CCOP(=O)(O)OP(=O)(O)O)C
prephenate	C1=CC(C=CC1O)(CC(=O)C(=O)O)C(=O)O
preuroporphyrinogen	C1=C(C(=C(N1)CC2=C(C(=C(N2)CC3=C(C(=C(N3)CC4=C(C(=C(N4)CO)CC(=O)O)CCC(=O)O)CC(=O)O)CCC(=O)O)CC(=O)O)CCC(=O)O)CC(=O)O)CCC(=O)O
propionyl-CoA	CCC(=O)SCCNC(=O)CCNC(=O)C(C(C)(C)COP(=O)(O)OP(=O)(O)OCC1C(C(C(O1)N2C=NC3=C(N=CN=C32)N)O)OP(=O)(O)O)O
protein	
protoporphyrin	CC1=C(C2=CC3=NC(=CC4=NC(=CC5=C(C(=C(N5)C=C1N2)C=C)C)C(=C4CCC(=O)O)C)C(=C3C)CCC(=O)O)C=C
protoporphyrinogen	CC1=C2CC3=C(C(=C(N3)CC4=C(C(=C(N4)CC5=C(C(=C(N5)CC(=C1CCC(=O)O)N2)CCC(=O)O)C)C=C)C)C=C)C
pseudouridine 5'-phosphate	C1=C(C(=O)NC(=O)N1)C2C(C(C(O2)COP(=O)(O)O)O)O
putrescine	C(CCN)CN
pyridoxal	CC1=NC=C(C(=C1O)C=O)CO
pyridoxal 5'-phosphate	CC1=NC=C(C(=C1O)C=O)COP(=O)(O)O
pyridoxamine	CC1=NC=C(C(=C1O)CN)CO
pyridoxamine 5'-phosphate	CC1=NC=C(C(=C1O)CN)COP(=O)(O)O
pyridoxine	CC1=NC=C(C(=C1O)CO)CO
pyridoxine 5'-phosphate	CC1=NC=C(C(=C1O)CO)COP(=O)(O)O
pyruvate	CC(=O)C(=O)[O-]
quinaldic acid	C1=CC=C2C(=C1)C=CC(=N2)C(=O)O
quinolinate	C1=CC(=C(N=C1)C(=O)O)C(=O)O
raffinose	C(C1C(C(C(C(O1)OCC2C(C(C(C(O2)OC3(C(C(C(O3)CO)O)O)CO)O)O)O)O)O)O)O
riboflavin	CC1=CC2=C(C=C1C)N(C3=NC(=O)NC(=O)C3=N2)CC(C(C(CO)O)O)O
ribose-5-phosphate	C(C(C(C(C=O)O)O)O)OP(=O)(O)O
sedoheptulose 1,7-bisphosphate	C(C(C(C(C(C(=O)COP(=O)(O)O)O)O)O)O)OP(=O)(O)O
sedoheptulose 7-phosphate	C(C(C(C(C(C(=O)CO)O)O)O)O)OP(=O)(O)O
shikimate	C1C(C(C(C=C1C(=O)O)O)O)O
siroheme_ActiveX VT_ERROR:	
sirohydrochlorin	CC1(C(C2=NC1=CC3=NC(=CC4=C(C(=C(N4)C=C5C(=C(C(=C2)N5)CC(=O)O)CCC(=O)O)CCC(=O)O)CC(=O)O)C(C3CCC(=O)O)(C)CC(=O)O)CCC(=O)O)CC(=O)O
sn-2-acyl-1-lysophosphatidylinositol	
sn-glycero-3-phosphocholine	C[N+](C)(C)CCOP(=O)([O-])OCC(CO)O
sn-glycero-3-phosphoethanolamine	C(COP(=O)(O)OCC(CO)O)N
sn-glycero-3-phosphoserine	C(C(COP(=O)(O)OCC(C(=O)O)N)O)O
sodium_Na.H	
spermidine	C(CCNCCCN)CN
spermine	C(CCNCCCN)CNCCCN
sphinganine	CCCCCCCCCCCCCCCC(C(CO)N)O
sphinganine 1-phosphate	CCCCCCCCCCCCCCCC(C(COP(=O)(O)O)N)O
squalene	CC(=CCCC(=CCCC(=CCCC=C(C)CCC=C(C)CCC=C(C)C)C)C)C
stearate	CCCCCCCCCCCCCCCCCC(=O)[O-]
stearoyl-CoA	CCCCCCCCCCCCCCCCCC(=O)SCCNC(=O)CCNC(=O)C(C(C)(C)COP(=O)(O)OP(=O)(O)OCC1C(C(C(O1)N2C=NC3=C(N=CN=C32)N)O)OP(=O)(O)O)O
succinate	C(CC(=O)[O-])C(=O)[O-]
succinic semialdehyde	C(CC(=O)O)C=O
succinyl-CoA	CC(C)(COP(=O)(O)OP(=O)(O)OCC1C(C(C(O1)N2C=NC3=C(N=CN=C32)N)O)OP(=O)(O)O)C(C(=O)NCCC(=O)NCCSC(=O)CCC(=O)O)O
sucrose	C(C1C(C(C(C(O1)OC2(C(C(C(O2)CO)O)O)CO)O)O)O)O
sulphate	[O-]S(=O)(=O)[O-]
sulphite	[O-]S(=O)[O-]
tRNA(Ala)_ActiveX VT_ERROR:	
tRNA(Arg), mitchondrial	
tRNA(Arg)_ActiveX VT_ERROR:	
tRNA(Asn), mitchondrial	
tRNA(Asn)_ActiveX VT_ERROR:	
tRNA(Asp), mitchondrial	
tRNA(Asp)_ActiveX VT_ERROR:	
tRNA(Cys)_ActiveX VT_ERROR:	
tRNA(Gln)_ActiveX VT_ERROR:	
tRNA(Glu), mitchondrial	
tRNA(Glu)_ActiveX VT_ERROR:	
tRNA(Gly)_ActiveX VT_ERROR:	
tRNA(His), mitchondrial	
tRNA(His)_ActiveX VT_ERROR:	
tRNA(Ile), mitchondrial	
tRNA(Ile)_ActiveX VT_ERROR:	
tRNA(Leu), mitchondrial	
tRNA(Leu)_ActiveX VT_ERROR:	
tRNA(Lys), mitchondrial_ActiveX VT_ERROR:	
tRNA(Lys)_ActiveX VT_ERROR:	
tRNA(Met), mitchondrial	
tRNA(Met)_ActiveX VT_ERROR:	
tRNA(Phe), mitchondrial	
tRNA(Phe)_ActiveX VT_ERROR:	
tRNA(Pro)_ActiveX VT_ERROR:	
tRNA(Ser)_ActiveX VT_ERROR:	
tRNA(Thr), mitchondrial	
tRNA(Thr)_ActiveX VT_ERROR:	
tRNA(Trp), mitchondrial	
tRNA(Trp)_ActiveX VT_ERROR:	
tRNA(Tyr), mitchondrial_ActiveX VT_ERROR:	
tRNA(Tyr)_ActiveX VT_ERROR:	
tRNA(Val), mitchondrial	
tRNA(Val)_ActiveX VT_ERROR:	
taurine	C(CS(=O)(=O)O)N
taurocholic acid	CC(CCC(=O)NCCS(=O)(=O)O)C1CCC2C1(C(CC3C2C(CC4C3(CCC(C4)O)C)O)O)C
tetracosanoyl-CoA	CCCCCCCCCCCCCCCCCCCCCCCC(=O)SCCNC(=O)CCNC(=O)C(C(C)(C)COP(=O)(O)OP(=O)(O)OCC1C(C(C(O1)N2C=NC3=C(N=CN=C32)N)O)OP(=O)(O)O)O
tetradecaprenyl diphosphate	CC(=CCCC(=CCCC(=CCCC(=CCCC(=CCCC(=CCCC(=CCCC(=CCCC(=CCCC(=CCCC(=CCCC(=CCCC(=CCCC(=CCOP(=O)(O)OP(=O)(O)O)C)C)C)C)C)C)C)C)C)C)C)C)C)C
tetrahydropteroyltri-L-glutamic acid	C1C(NC2=C(N1)N=C(NC2=O)N)CNC3=CC=C(C=C3)C(=O)NC(CCC(=O)NC(CCC(=O)NC(CCC(=O)O)C(=O)O)C(=O)O)C(=O)O
thiamine	CC1=C(SC=[N+]1CC2=CN=C(N=C2N)C)CCO
thymidine	CC1=CN(C(=O)NC1=O)C2CC(C(O2)CO)O
thymine	CC1=CNC(=O)NC1=O
trans-2,cis-5-dodecadienoyl-CoA	
trans-2,cis-5-tetradecadienoyl-CoA	
trans-2,cis-7-hexadecadienoyl-CoA	
trans-2,cis-7-tetradecadienoyl-CoA	
trans-2,cis-9-hexadecadienoyl-CoA	
trans-2,cis-9-octadecadienoyl-CoA	
trans-2,trans-4-dodecadienoyl-CoA	
trans-2,trans-4-tetradecadienoyl-CoA	
trans-3,cis-5-dodecadienoyl-CoA	
trans-3,cis-5-tetradecadienoyl-CoA	
trans-aconitate_ActiveX VT_ERROR:	
trans-but-2-enoyl-ACP	
trans-but-2-enoyl-CoA	CC=CC(=O)SCCNC(=O)CCNC(=O)C(C(C)(C)COP(=O)(O)OP(=O)(O)OCC1C(C(C(O1)N2C=NC3=C(N=CN=C32)N)O)OP(=O)(O)O)O
trans-dec-2-enoyl-CoA	CCCCCCCC=CC(=O)SCCNC(=O)CCNC(=O)C(C(C)(C)COP(=O)(O)OP(=O)(O)OCC1C(C(C(O1)N2C=NC3=C(N=CN=C32)N)O)OP(=O)(O)O)O
trans-docos-2-enoyl-CoA	CCCCCCCCCCCCCCCCCCCC=CC(=O)SCCNC(=O)CCNC(=O)C(C(C)(C)COP(=O)([O-])OP(=O)([O-])OCC1C(C(C(O1)N2C=NC3=C(N=CN=C32)N)O)OP(=O)([O-])[O-])O
trans-dodec-2-enoyl-CoA	CCCCCCCCCC=CC(=O)SCCNC(=O)CCNC(=O)C(C(C)(C)COP(=O)(O)OP(=O)(O)OCC1C(C(C(O1)N2C=NC3=C(N=CN=C32)N)O)OP(=O)(O)O)O
trans-dodec-3-enoyl-CoA	
trans-hex-2-enoyl-ACP	
trans-hex-2-enoyl-CoA	CCCC=CC(=O)SCCNC(=O)CCNC(=O)C(C(C)(C)COP(=O)(O)OP(=O)(O)OCC1C(C(C(O1)N2C=NC3=C(N=CN=C32)N)O)OP(=O)(O)O)O
trans-hexacos-2-enoyl-CoA	CCCCCCCCCCCCCCCCCCCCCCCC=CC(=O)SCCNC(=O)CCNC(=O)C(C(C)(C)COP(=O)(O)OP(=O)(O)OCC1C(C(C(O1)N2C=NC3=C(N=CN=C32)N)O)OP(=O)(O)O)O
trans-hexadec-2-enoyl-CoA_ActiveX VT_ERROR:	
trans-icos-2-enoyl-CoA	
trans-oct-2-enoyl-ACP	
trans-oct-2-enoyl-CoA	CCCCCC=CC(=O)SCCNC(=O)CCNC(=O)C(C(C)(C)COP(=O)(O)OP(=O)(O)OCC1C(C(C(O1)N2C=NC3=C(N=CN=C32)N)O)OP(=O)(O)O)O
trans-octadec-2-enoyl-CoA	CCCCCCCCCCCCCCCC=CC(=O)SCCNC(=O)CCNC(=O)C(C(C)(C)COP(=O)(O)OP(=O)(O)OCC1C(C(C(O1)N2C=NC3=C(N=CN=C32)N)O)OP(=O)(O)O)O
trans-tetracos-2-enoyl-CoA	
trans-tetradec-2-enoyl-CoA	CCCCCCCCCCCC=CC(=O)SCCNC(=O)CCNC(=O)C(C(C)(C)COP(=O)(O)OP(=O)(O)OCC1C(C(C(O1)N2C=NC3=C(N=CN=C32)N)O)OP(=O)(O)O)O
trans-tetradec-3-enoyl-CoA	
trehalose	C(C1C(C(C(C(O1)OC2C(C(C(C(O2)CO)O)O)O)O)O)O)O
tributyrin	CCCC(=O)OCC(COC(=O)CCC)OC(=O)CCC
tridecaprenyl diphosphate	CC(=CCCC(=CCCC(=CCCC(=CCCC(=CCCC(=CCCC(=CCCC(=CCCC(=CCCC(=CCCC(=CCCC(=CCCC(=CCOP(=O)(O)OP(=O)(O)O)C)C)C)C)C)C)C)C)C)C)C)C)C
triglyceride_ActiveX VT_ERROR:	
trimethylenediamine	C(CN)CN
ubiquinol-6	CC1=C(C(=C(C(=C1O)OC)OC)O)CC=C(C)CCC=C(C)CCC=C(C)CCC=C(C)CCC=C(C)CCC=C(C)C
ubiquinone-6	CC1=C(C(=O)C(=C(C1=O)OC)OC)CC=C(C)CCC=C(C)CCC=C(C)CCC=C(C)CCC=C(C)CCC=C(C)C
undecaprenyl diphosphate	CC(=CCCC(=CCCC(=CCCC(=CCCC(=CCCC(=CCCC(=CCCC(=CCCC(=CCCC(=CCCC(=CCOP(=O)(O)OP(=O)(O)O)C)C)C)C)C)C)C)C)C)C)C
uracil	C1=CNC(=O)NC1=O
urate	C12=C(NC(=O)N1)NC(=O)NC2=O
urea	C(=O)(N)N
urea-1-carboxylic acid	C(=O)(N)NC(=O)O
ureidoglycolic acid	C(C(=O)O)(NC(=O)N)O
uridine	C1=CN(C(=O)NC1=O)C2C(C(C(O2)CO)O)O
uroporphyrinogen III	C1C2=C(C(=C(N2)CC3=C(C(=C(N3)CC4=C(C(=C(N4)CC5=C(C(=C1N5)CCC(=O)O)CC(=O)O)CC(=O)O)CCC(=O)O)CC(=O)O)CCC(=O)O)CC(=O)O)CCC(=O)O
xanthosine	C1=NC2=C(N1C3C(C(C(O3)CO)O)O)NC(=O)NC2=O
xanthosine-5-phosphate	C1=NC2=C(N1C3C(C(C(O3)COP(=O)(O)O)O)O)NC(=O)NC2=O
xylitol	C(C(C(C(CO)O)O)O)O
zymosterol	CC(CCC=C(C)C)C1CCC2C1(CCC3=C2CCC4C3(CCC(C4)O)C)C
zymosterol intermediate 1a	CC(CCC=C(C)C)C1CCC2C1(CCC3=C2CCC4C3(CCC(C4CO)O)C)C
zymosterol intermediate 1b	CC(CCC=C(C)C)C1CCC2C1(CCC3=C2CCC4C3(CCC(C4C=O)O)C)C
zymosterol intermediate 1c	CC(CCC=C(C)C)C1CCC2C1(CCC3=C2CCC4C3(CCC(C4C(=O)C)O)C)C
zymosterol intermediate 2	CC(CCC=C(C)C)C1CCC2C1(CCC3=C2CCC4C3(CCC(=O)C4)C)C
zymosteryl oleate	CCCCCCCCC=CCCCCCCCC(=O)OC1CCC2(C(C1)CCC3=C2CCC4(C3CCC4C(C)CCC=C(C)C)C)C
zymosteryl palmitoleate	CCCCCCC=CCCCCCCCC(=O)OC1CCC2(C(C1)CCC3=C2CCC4(C3CCC4C(C)CCC=C(C)C)C)C
	
cerotate	CCCCCCCCCCCCCCCCCCCCCCCCCC(=O)[O-]
ergosterol ester	
myristoleate	CCCCC=CCCCCCCCC(=O)[O-]
myristoleoyl-CoA	CCCCC=CCCCCCCCC(=O)SCCNC(=O)CCNC(=O)C(C(C)(C)COP(=O)(O)OP(=O)(O)OCC1C(C(C(O1)N2C=NC3=C(N=CN=C32)N)O)OP(=O)(O)O)O
